GEO.id,GEO.id2,GEO.display-label,HD01_VD01,HD02_VD01,HD01_VD02,HD02_VD02,HD01_VD03,HD02_VD03
1400000US08001007801,8001007801,"Census Tract 78.01, Adams County, Colorado",1166,81,106,54,1060,84
1400000US08001007802,8001007802,"Census Tract 78.02, Adams County, Colorado",1187,103,129,59,1058,121
1400000US08001007900,8001007900,"Census Tract 79, Adams County, Colorado",1750,97,457,73,1293,107
1400000US08001008000,8001008000,"Census Tract 80, Adams County, Colorado",1762,76,1006,132,756,130
1400000US08001008100,8001008100,"Census Tract 81, Adams County, Colorado",514,61,48,30,466,62
1400000US08001008200,8001008200,"Census Tract 82, Adams County, Colorado",1452,69,964,123,488,104
1400000US08001008308,8001008308,"Census Tract 83.08, Adams County, Colorado",1752,134,921,162,831,152
1400000US08001008309,8001008309,"Census Tract 83.09, Adams County, Colorado",1056,69,731,102,325,105
1400000US08001008353,8001008353,"Census Tract 83.53, Adams County, Colorado",2016,141,1432,183,584,168
1400000US08001008401,8001008401,"Census Tract 84.01, Adams County, Colorado",1603,115,1338,124,265,86
1400000US08001008402,8001008402,"Census Tract 84.02, Adams County, Colorado",1567,94,1374,110,193,68
1400000US08001008505,8001008505,"Census Tract 85.05, Adams County, Colorado",2519,134,2022,181,497,159
1400000US08001008506,8001008506,"Census Tract 85.06, Adams County, Colorado",2606,191,478,135,2128,223
1400000US08001008507,8001008507,"Census Tract 85.07, Adams County, Colorado",2176,124,1695,169,481,155
1400000US08001008508,8001008508,"Census Tract 85.08, Adams County, Colorado",1834,91,1207,136,627,115
1400000US08001008523,8001008523,"Census Tract 85.23, Adams County, Colorado",2554,133,2269,174,285,126
1400000US08001008524,8001008524,"Census Tract 85.24, Adams County, Colorado",2512,99,2281,142,231,104
1400000US08001008526,8001008526,"Census Tract 85.26, Adams County, Colorado",2449,69,1853,165,596,145
1400000US08001008529,8001008529,"Census Tract 85.29, Adams County, Colorado",3058,179,1187,225,1871,250
1400000US08001008533,8001008533,"Census Tract 85.33, Adams County, Colorado",3074,146,1475,166,1599,205
1400000US08001008534,8001008534,"Census Tract 85.34, Adams County, Colorado",1399,51,1246,91,153,78
1400000US08001008535,8001008535,"Census Tract 85.35, Adams County, Colorado",1203,76,844,160,359,142
1400000US08001008536,8001008536,"Census Tract 85.36, Adams County, Colorado",832,84,730,92,102,54
1400000US08001008537,8001008537,"Census Tract 85.37, Adams County, Colorado",1737,179,1493,195,244,109
1400000US08001008538,8001008538,"Census Tract 85.38, Adams County, Colorado",1930,104,1794,112,136,66
1400000US08001008539,8001008539,"Census Tract 85.39, Adams County, Colorado",2773,143,2528,197,245,115
1400000US08001008540,8001008540,"Census Tract 85.40, Adams County, Colorado",2289,130,2179,136,110,81
1400000US08001008541,8001008541,"Census Tract 85.41, Adams County, Colorado",1581,103,1529,106,52,43
1400000US08001008542,8001008542,"Census Tract 85.42, Adams County, Colorado",2198,143,1917,191,281,116
1400000US08001008543,8001008543,"Census Tract 85.43, Adams County, Colorado",2469,149,1886,165,583,134
1400000US08001008544,8001008544,"Census Tract 85.44, Adams County, Colorado",1373,100,1301,111,72,56
1400000US08001008545,8001008545,"Census Tract 85.45, Adams County, Colorado",2179,78,1919,110,260,102
1400000US08001008546,8001008546,"Census Tract 85.46, Adams County, Colorado",1048,64,814,115,234,97
1400000US08001008547,8001008547,"Census Tract 85.47, Adams County, Colorado",1156,53,856,96,300,97
1400000US08001008548,8001008548,"Census Tract 85.48, Adams County, Colorado",526,48,399,68,127,60
1400000US08001008549,8001008549,"Census Tract 85.49, Adams County, Colorado",1330,66,1011,109,319,100
1400000US08001008550,8001008550,"Census Tract 85.50, Adams County, Colorado",2557,129,2347,148,210,86
1400000US08001008551,8001008551,"Census Tract 85.51, Adams County, Colorado",335,36,264,72,71,76
1400000US08001008603,8001008603,"Census Tract 86.03, Adams County, Colorado",769,49,317,72,452,77
1400000US08001008604,8001008604,"Census Tract 86.04, Adams County, Colorado",1169,60,660,98,509,88
1400000US08001008605,8001008605,"Census Tract 86.05, Adams County, Colorado",1305,74,830,109,475,113
1400000US08001008606,8001008606,"Census Tract 86.06, Adams County, Colorado",2172,116,1183,160,989,167
1400000US08001008705,8001008705,"Census Tract 87.05, Adams County, Colorado",1467,102,940,113,527,126
1400000US08001008706,8001008706,"Census Tract 87.06, Adams County, Colorado",1546,112,861,113,685,123
1400000US08001008709,8001008709,"Census Tract 87.09, Adams County, Colorado",2409,169,1009,217,1400,249
1400000US08001008801,8001008801,"Census Tract 88.01, Adams County, Colorado",1421,89,835,97,586,107
1400000US08001008802,8001008802,"Census Tract 88.02, Adams County, Colorado",1201,76,741,111,460,101
1400000US08001008901,8001008901,"Census Tract 89.01, Adams County, Colorado",728,45,439,63,289,69
1400000US08001009001,8001009001,"Census Tract 90.01, Adams County, Colorado",1500,65,942,122,558,117
1400000US08001009002,8001009002,"Census Tract 90.02, Adams County, Colorado",3192,146,1855,225,1337,197
1400000US08001009101,8001009101,"Census Tract 91.01, Adams County, Colorado",1326,76,969,115,357,109
1400000US08001009103,8001009103,"Census Tract 91.03, Adams County, Colorado",997,89,686,109,311,101
1400000US08001009104,8001009104,"Census Tract 91.04, Adams County, Colorado",1715,102,1160,133,555,114
1400000US08001009202,8001009202,"Census Tract 92.02, Adams County, Colorado",1320,75,858,113,462,101
1400000US08001009203,8001009203,"Census Tract 92.03, Adams County, Colorado",1446,117,98,30,1348,114
1400000US08001009204,8001009204,"Census Tract 92.04, Adams County, Colorado",2434,150,1268,165,1166,167
1400000US08001009206,8001009206,"Census Tract 92.06, Adams County, Colorado",792,56,658,72,134,67
1400000US08001009207,8001009207,"Census Tract 92.07, Adams County, Colorado",1568,73,854,112,714,118
1400000US08001009304,8001009304,"Census Tract 93.04, Adams County, Colorado",2176,89,1270,166,906,152
1400000US08001009306,8001009306,"Census Tract 93.06, Adams County, Colorado",1197,74,951,123,246,100
1400000US08001009307,8001009307,"Census Tract 93.07, Adams County, Colorado",1215,78,660,89,555,85
1400000US08001009308,8001009308,"Census Tract 93.08, Adams County, Colorado",1331,86,738,156,593,147
1400000US08001009309,8001009309,"Census Tract 93.09, Adams County, Colorado",1342,98,655,94,687,127
1400000US08001009310,8001009310,"Census Tract 93.10, Adams County, Colorado",1947,86,1026,126,921,124
1400000US08001009316,8001009316,"Census Tract 93.16, Adams County, Colorado",2010,158,1500,194,510,162
1400000US08001009318,8001009318,"Census Tract 93.18, Adams County, Colorado",2167,129,836,160,1331,153
1400000US08001009319,8001009319,"Census Tract 93.19, Adams County, Colorado",855,89,480,78,375,81
1400000US08001009320,8001009320,"Census Tract 93.20, Adams County, Colorado",1108,87,455,101,653,100
1400000US08001009321,8001009321,"Census Tract 93.21, Adams County, Colorado",1418,119,759,101,659,110
1400000US08001009322,8001009322,"Census Tract 93.22, Adams County, Colorado",1394,110,1051,126,343,93
1400000US08001009323,8001009323,"Census Tract 93.23, Adams County, Colorado",1518,87,558,87,960,115
1400000US08001009325,8001009325,"Census Tract 93.25, Adams County, Colorado",2202,182,1204,194,998,182
1400000US08001009326,8001009326,"Census Tract 93.26, Adams County, Colorado",1066,75,793,90,273,83
1400000US08001009327,8001009327,"Census Tract 93.27, Adams County, Colorado",1608,112,1166,120,442,118
1400000US08001009401,8001009401,"Census Tract 94.01, Adams County, Colorado",1819,62,1254,102,565,92
1400000US08001009406,8001009406,"Census Tract 94.06, Adams County, Colorado",1755,60,1152,103,603,108
1400000US08001009407,8001009407,"Census Tract 94.07, Adams County, Colorado",1755,80,917,114,838,124
1400000US08001009408,8001009408,"Census Tract 94.08, Adams County, Colorado",1670,83,1353,113,317,78
1400000US08001009409,8001009409,"Census Tract 94.09, Adams County, Colorado",2133,121,1482,148,651,133
1400000US08001009410,8001009410,"Census Tract 94.10, Adams County, Colorado",1180,70,1128,80,52,44
1400000US08001009411,8001009411,"Census Tract 94.11, Adams County, Colorado",1228,63,766,102,462,91
1400000US08001009501,8001009501,"Census Tract 95.01, Adams County, Colorado",1130,62,703,96,427,100
1400000US08001009502,8001009502,"Census Tract 95.02, Adams County, Colorado",1289,62,963,120,326,104
1400000US08001009553,8001009553,"Census Tract 95.53, Adams County, Colorado",1059,84,583,97,476,105
1400000US08001009603,8001009603,"Census Tract 96.03, Adams County, Colorado",2159,140,1071,129,1088,183
1400000US08001009604,8001009604,"Census Tract 96.04, Adams County, Colorado",1934,107,885,117,1049,140
1400000US08001009606,8001009606,"Census Tract 96.06, Adams County, Colorado",995,100,284,68,711,111
1400000US08001009607,8001009607,"Census Tract 96.07, Adams County, Colorado",1788,94,817,107,971,141
1400000US08001009608,8001009608,"Census Tract 96.08, Adams County, Colorado",1224,147,1063,160,161,78
1400000US08001009751,8001009751,"Census Tract 97.51, Adams County, Colorado",1366,85,607,128,759,124
1400000US08001009752,8001009752,"Census Tract 97.52, Adams County, Colorado",1084,37,778,98,306,90
1400000US08001015000,8001015000,"Census Tract 150, Adams County, Colorado",1062,80,781,101,281,88
1400000US08001060000,8001060000,"Census Tract 600, Adams County, Colorado",1514,82,1424,115,90,85
1400000US08001060100,8001060100,"Census Tract 601, Adams County, Colorado",2205,134,1815,180,390,138
1400000US08001060200,8001060200,"Census Tract 602, Adams County, Colorado",1730,107,584,106,1146,127
1400000US08001061200,8001061200,"Census Tract 612, Adams County, Colorado",415,42,366,51,49,36
1400000US08001988700,8001988700,"Census Tract 9887, Adams County, Colorado",0,12,0,12,0,12
1400000US08005004951,8005004951,"Census Tract 49.51, Arapahoe County, Colorado",1048,94,112,57,936,98
1400000US08005004952,8005004952,"Census Tract 49.52, Arapahoe County, Colorado",1453,151,23,26,1430,151
1400000US08005005551,8005005551,"Census Tract 55.51, Arapahoe County, Colorado",1140,67,476,105,664,96
1400000US08005005552,8005005552,"Census Tract 55.52, Arapahoe County, Colorado",1049,126,644,101,405,90
1400000US08005005553,8005005553,"Census Tract 55.53, Arapahoe County, Colorado",1400,86,782,110,618,127
1400000US08005005611,8005005611,"Census Tract 56.11, Arapahoe County, Colorado",1887,81,1558,108,329,106
1400000US08005005612,8005005612,"Census Tract 56.12, Arapahoe County, Colorado",1513,57,971,72,542,69
1400000US08005005614,8005005614,"Census Tract 56.14, Arapahoe County, Colorado",1288,44,1191,75,97,57
1400000US08005005619,8005005619,"Census Tract 56.19, Arapahoe County, Colorado",1746,83,1386,105,360,94
1400000US08005005620,8005005620,"Census Tract 56.20, Arapahoe County, Colorado",1697,78,838,119,859,109
1400000US08005005621,8005005621,"Census Tract 56.21, Arapahoe County, Colorado",1151,54,1014,56,137,59
1400000US08005005622,8005005622,"Census Tract 56.22, Arapahoe County, Colorado",962,59,685,43,277,51
1400000US08005005623,8005005623,"Census Tract 56.23, Arapahoe County, Colorado",1636,77,1367,92,269,77
1400000US08005005624,8005005624,"Census Tract 56.24, Arapahoe County, Colorado",837,32,775,38,62,32
1400000US08005005625,8005005625,"Census Tract 56.25, Arapahoe County, Colorado",1195,57,918,114,277,106
1400000US08005005626,8005005626,"Census Tract 56.26, Arapahoe County, Colorado",1561,84,1108,107,453,106
1400000US08005005627,8005005627,"Census Tract 56.27, Arapahoe County, Colorado",1796,66,1657,81,139,71
1400000US08005005628,8005005628,"Census Tract 56.28, Arapahoe County, Colorado",2298,48,1638,152,660,153
1400000US08005005629,8005005629,"Census Tract 56.29, Arapahoe County, Colorado",822,37,805,44,17,17
1400000US08005005630,8005005630,"Census Tract 56.30, Arapahoe County, Colorado",2118,117,1935,141,183,102
1400000US08005005631,8005005631,"Census Tract 56.31, Arapahoe County, Colorado",1213,47,1159,65,54,51
1400000US08005005632,8005005632,"Census Tract 56.32, Arapahoe County, Colorado",1177,50,948,73,229,67
1400000US08005005633,8005005633,"Census Tract 56.33, Arapahoe County, Colorado",1306,48,989,84,317,86
1400000US08005005634,8005005634,"Census Tract 56.34, Arapahoe County, Colorado",1553,89,1328,96,225,77
1400000US08005005635,8005005635,"Census Tract 56.35, Arapahoe County, Colorado",2017,75,1608,147,409,138
1400000US08005005636,8005005636,"Census Tract 56.36, Arapahoe County, Colorado",657,46,657,46,0,12
1400000US08005005700,8005005700,"Census Tract 57, Arapahoe County, Colorado",1672,149,579,86,1093,154
1400000US08005005800,8005005800,"Census Tract 58, Arapahoe County, Colorado",1143,88,780,110,363,101
1400000US08005005951,8005005951,"Census Tract 59.51, Arapahoe County, Colorado",2319,151,575,161,1744,220
1400000US08005005952,8005005952,"Census Tract 59.52, Arapahoe County, Colorado",1397,101,576,84,821,110
1400000US08005006000,8005006000,"Census Tract 60, Arapahoe County, Colorado",1302,79,642,79,660,91
1400000US08005006100,8005006100,"Census Tract 61, Arapahoe County, Colorado",1354,69,660,90,694,92
1400000US08005006200,8005006200,"Census Tract 62, Arapahoe County, Colorado",1251,94,909,102,342,92
1400000US08005006300,8005006300,"Census Tract 63, Arapahoe County, Colorado",1026,76,797,94,229,90
1400000US08005006400,8005006400,"Census Tract 64, Arapahoe County, Colorado",1247,74,799,79,448,90
1400000US08005006501,8005006501,"Census Tract 65.01, Arapahoe County, Colorado",1191,93,88,55,1103,107
1400000US08005006502,8005006502,"Census Tract 65.02, Arapahoe County, Colorado",1441,90,826,105,615,117
1400000US08005006601,8005006601,"Census Tract 66.01, Arapahoe County, Colorado",2396,158,646,112,1750,188
1400000US08005006603,8005006603,"Census Tract 66.03, Arapahoe County, Colorado",1386,73,1002,83,384,75
1400000US08005006604,8005006604,"Census Tract 66.04, Arapahoe County, Colorado",1911,69,779,88,1132,119
1400000US08005006704,8005006704,"Census Tract 67.04, Arapahoe County, Colorado",1466,78,1440,82,26,22
1400000US08005006705,8005006705,"Census Tract 67.05, Arapahoe County, Colorado",619,44,564,53,55,46
1400000US08005006706,8005006706,"Census Tract 67.06, Arapahoe County, Colorado",2052,82,1541,121,511,107
1400000US08005006707,8005006707,"Census Tract 67.07, Arapahoe County, Colorado",1859,55,1443,105,416,98
1400000US08005006708,8005006708,"Census Tract 67.08, Arapahoe County, Colorado",1950,60,1634,79,316,69
1400000US08005006709,8005006709,"Census Tract 67.09, Arapahoe County, Colorado",2072,93,1876,89,196,93
1400000US08005006711,8005006711,"Census Tract 67.11, Arapahoe County, Colorado",1452,49,1360,58,92,44
1400000US08005006712,8005006712,"Census Tract 67.12, Arapahoe County, Colorado",486,55,429,44,57,45
1400000US08005006713,8005006713,"Census Tract 67.13, Arapahoe County, Colorado",711,46,0,12,711,46
1400000US08005006808,8005006808,"Census Tract 68.08, Arapahoe County, Colorado",1799,57,1673,80,126,60
1400000US08005006815,8005006815,"Census Tract 68.15, Arapahoe County, Colorado",1785,79,805,85,980,104
1400000US08005006854,8005006854,"Census Tract 68.54, Arapahoe County, Colorado",1041,77,479,74,562,86
1400000US08005006855,8005006855,"Census Tract 68.55, Arapahoe County, Colorado",1919,69,1496,110,423,95
1400000US08005006856,8005006856,"Census Tract 68.56, Arapahoe County, Colorado",3201,188,1305,204,1896,220
1400000US08005006857,8005006857,"Census Tract 68.57, Arapahoe County, Colorado",883,37,788,50,95,41
1400000US08005006858,8005006858,"Census Tract 68.58, Arapahoe County, Colorado",2626,140,493,141,2133,176
1400000US08005007101,8005007101,"Census Tract 71.01, Arapahoe County, Colorado",1908,85,1498,95,410,87
1400000US08005007103,8005007103,"Census Tract 71.03, Arapahoe County, Colorado",558,46,512,57,46,32
1400000US08005007104,8005007104,"Census Tract 71.04, Arapahoe County, Colorado",1564,89,1031,129,533,134
1400000US08005007105,8005007105,"Census Tract 71.05, Arapahoe County, Colorado",1313,155,1144,162,169,91
1400000US08005007106,8005007106,"Census Tract 71.06, Arapahoe County, Colorado",1528,129,1367,106,161,106
1400000US08005007107,8005007107,"Census Tract 71.07, Arapahoe County, Colorado",1785,103,1426,104,359,105
1400000US08005007201,8005007201,"Census Tract 72.01, Arapahoe County, Colorado",1208,77,397,77,811,88
1400000US08005007202,8005007202,"Census Tract 72.02, Arapahoe County, Colorado",1356,62,547,104,809,103
1400000US08005007301,8005007301,"Census Tract 73.01, Arapahoe County, Colorado",871,84,171,57,700,98
1400000US08005007302,8005007302,"Census Tract 73.02, Arapahoe County, Colorado",1607,109,317,74,1290,127
1400000US08005007400,8005007400,"Census Tract 74, Arapahoe County, Colorado",1608,60,773,91,835,105
1400000US08005007500,8005007500,"Census Tract 75, Arapahoe County, Colorado",784,49,456,73,328,70
1400000US08005007600,8005007600,"Census Tract 76, Arapahoe County, Colorado",1254,55,535,89,719,87
1400000US08005007702,8005007702,"Census Tract 77.02, Arapahoe County, Colorado",1494,79,816,73,678,105
1400000US08005007703,8005007703,"Census Tract 77.03, Arapahoe County, Colorado",1569,89,739,104,830,125
1400000US08005007704,8005007704,"Census Tract 77.04, Arapahoe County, Colorado",1850,85,702,98,1148,125
1400000US08005015100,8005015100,"Census Tract 151, Arapahoe County, Colorado",1015,48,913,81,102,56
1400000US08005080000,8005080000,"Census Tract 800, Arapahoe County, Colorado",1267,77,628,87,639,101
1400000US08005080100,8005080100,"Census Tract 801, Arapahoe County, Colorado",1805,108,779,123,1026,145
1400000US08005080200,8005080200,"Census Tract 802, Arapahoe County, Colorado",1892,89,1302,113,590,108
1400000US08005080300,8005080300,"Census Tract 803, Arapahoe County, Colorado",2276,113,1514,181,762,201
1400000US08005080400,8005080400,"Census Tract 804, Arapahoe County, Colorado",2005,70,1560,116,445,109
1400000US08005080500,8005080500,"Census Tract 805, Arapahoe County, Colorado",1621,101,992,104,629,130
1400000US08005080600,8005080600,"Census Tract 806, Arapahoe County, Colorado",1799,102,692,132,1107,153
1400000US08005080700,8005080700,"Census Tract 807, Arapahoe County, Colorado",1784,110,1072,135,712,118
1400000US08005080800,8005080800,"Census Tract 808, Arapahoe County, Colorado",1026,70,494,86,532,96
1400000US08005080900,8005080900,"Census Tract 809, Arapahoe County, Colorado",1281,68,1000,100,281,87
1400000US08005081000,8005081000,"Census Tract 810, Arapahoe County, Colorado",2391,116,689,139,1702,171
1400000US08005081100,8005081100,"Census Tract 811, Arapahoe County, Colorado",2576,103,532,125,2044,166
1400000US08005081200,8005081200,"Census Tract 812, Arapahoe County, Colorado",1829,89,866,125,963,120
1400000US08005081300,8005081300,"Census Tract 813, Arapahoe County, Colorado",1011,78,650,92,361,95
1400000US08005081400,8005081400,"Census Tract 814, Arapahoe County, Colorado",1616,91,1195,99,421,98
1400000US08005081500,8005081500,"Census Tract 815, Arapahoe County, Colorado",2205,131,1792,161,413,116
1400000US08005081600,8005081600,"Census Tract 816, Arapahoe County, Colorado",1780,76,1130,115,650,115
1400000US08005081700,8005081700,"Census Tract 817, Arapahoe County, Colorado",966,46,901,59,65,45
1400000US08005081800,8005081800,"Census Tract 818, Arapahoe County, Colorado",1465,86,771,106,694,109
1400000US08005081900,8005081900,"Census Tract 819, Arapahoe County, Colorado",2321,172,1254,182,1067,203
1400000US08005082000,8005082000,"Census Tract 820, Arapahoe County, Colorado",1689,94,233,71,1456,108
1400000US08005082100,8005082100,"Census Tract 821, Arapahoe County, Colorado",2431,82,1090,145,1341,166
1400000US08005082200,8005082200,"Census Tract 822, Arapahoe County, Colorado",2184,110,1253,178,931,159
1400000US08005082300,8005082300,"Census Tract 823, Arapahoe County, Colorado",1425,51,771,115,654,112
1400000US08005082400,8005082400,"Census Tract 824, Arapahoe County, Colorado",1529,84,979,106,550,83
1400000US08005082500,8005082500,"Census Tract 825, Arapahoe County, Colorado",757,26,678,52,79,47
1400000US08005082600,8005082600,"Census Tract 826, Arapahoe County, Colorado",2070,124,755,175,1315,159
1400000US08005082700,8005082700,"Census Tract 827, Arapahoe County, Colorado",1142,74,978,85,164,81
1400000US08005082800,8005082800,"Census Tract 828, Arapahoe County, Colorado",1849,93,1482,157,367,134
1400000US08005082900,8005082900,"Census Tract 829, Arapahoe County, Colorado",1563,115,1129,144,434,132
1400000US08005083000,8005083000,"Census Tract 830, Arapahoe County, Colorado",1194,31,1103,74,91,66
1400000US08005083100,8005083100,"Census Tract 831, Arapahoe County, Colorado",2494,128,1676,268,818,276
1400000US08005083200,8005083200,"Census Tract 832, Arapahoe County, Colorado",2656,102,2476,158,180,112
1400000US08005083300,8005083300,"Census Tract 833, Arapahoe County, Colorado",1802,77,1469,119,333,104
1400000US08005083400,8005083400,"Census Tract 834, Arapahoe County, Colorado",2196,76,1809,137,387,135
1400000US08005083500,8005083500,"Census Tract 835, Arapahoe County, Colorado",2106,76,1118,88,988,100
1400000US08005083600,8005083600,"Census Tract 836, Arapahoe County, Colorado",1696,74,939,159,757,164
1400000US08005083700,8005083700,"Census Tract 837, Arapahoe County, Colorado",1610,112,1139,92,471,128
1400000US08005083800,8005083800,"Census Tract 838, Arapahoe County, Colorado",1170,57,879,126,291,121
1400000US08005083900,8005083900,"Census Tract 839, Arapahoe County, Colorado",1555,93,929,139,626,133
1400000US08005084000,8005084000,"Census Tract 840, Arapahoe County, Colorado",753,41,562,58,191,60
1400000US08005084100,8005084100,"Census Tract 841, Arapahoe County, Colorado",1532,85,1064,97,468,110
1400000US08005084200,8005084200,"Census Tract 842, Arapahoe County, Colorado",1324,46,1036,67,288,64
1400000US08005084300,8005084300,"Census Tract 843, Arapahoe County, Colorado",1169,46,940,94,229,90
1400000US08005084400,8005084400,"Census Tract 844, Arapahoe County, Colorado",1030,48,739,105,291,106
1400000US08005084500,8005084500,"Census Tract 845, Arapahoe County, Colorado",1152,86,380,58,772,99
1400000US08005084600,8005084600,"Census Tract 846, Arapahoe County, Colorado",1984,59,1065,118,919,133
1400000US08005084700,8005084700,"Census Tract 847, Arapahoe County, Colorado",1710,37,1385,102,325,106
1400000US08005084800,8005084800,"Census Tract 848, Arapahoe County, Colorado",1249,30,986,85,263,90
1400000US08005084900,8005084900,"Census Tract 849, Arapahoe County, Colorado",977,55,954,63,23,25
1400000US08005085000,8005085000,"Census Tract 850, Arapahoe County, Colorado",580,44,374,51,206,48
1400000US08005085100,8005085100,"Census Tract 851, Arapahoe County, Colorado",1997,54,1863,101,134,82
1400000US08005085200,8005085200,"Census Tract 852, Arapahoe County, Colorado",1004,18,942,46,62,45
1400000US08005085300,8005085300,"Census Tract 853, Arapahoe County, Colorado",998,33,521,97,477,93
1400000US08005085400,8005085400,"Census Tract 854, Arapahoe County, Colorado",1414,52,1309,82,105,60
1400000US08005085500,8005085500,"Census Tract 855, Arapahoe County, Colorado",1764,58,1533,94,231,84
1400000US08005085600,8005085600,"Census Tract 856, Arapahoe County, Colorado",1032,32,993,50,39,36
1400000US08005085700,8005085700,"Census Tract 857, Arapahoe County, Colorado",1764,89,1153,165,611,157
1400000US08005085800,8005085800,"Census Tract 858, Arapahoe County, Colorado",642,14,496,49,146,48
1400000US08005085900,8005085900,"Census Tract 859, Arapahoe County, Colorado",1066,63,947,85,119,72
1400000US08005086000,8005086000,"Census Tract 860, Arapahoe County, Colorado",2319,127,1768,140,551,125
1400000US08005086100,8005086100,"Census Tract 861, Arapahoe County, Colorado",1443,96,1309,108,134,69
1400000US08005086200,8005086200,"Census Tract 862, Arapahoe County, Colorado",1899,69,1678,101,221,81
1400000US08005086300,8005086300,"Census Tract 863, Arapahoe County, Colorado",1787,81,832,147,955,136
1400000US08005086400,8005086400,"Census Tract 864, Arapahoe County, Colorado",758,21,736,31,22,22
1400000US08005086500,8005086500,"Census Tract 865, Arapahoe County, Colorado",1919,133,1392,146,527,126
1400000US08005086600,8005086600,"Census Tract 866, Arapahoe County, Colorado",2163,136,1629,96,534,141
1400000US08005086700,8005086700,"Census Tract 867, Arapahoe County, Colorado",1205,80,1179,83,26,29
1400000US08005086800,8005086800,"Census Tract 868, Arapahoe County, Colorado",2796,146,1079,166,1717,185
1400000US08005086900,8005086900,"Census Tract 869, Arapahoe County, Colorado",1425,76,209,66,1216,93
1400000US08005087000,8005087000,"Census Tract 870, Arapahoe County, Colorado",2167,104,333,116,1834,144
1400000US08005087100,8005087100,"Census Tract 871, Arapahoe County, Colorado",1312,71,389,60,923,74
1400000US08005087200,8005087200,"Census Tract 872, Arapahoe County, Colorado",1994,162,691,120,1303,184
1400000US08005087300,8005087300,"Census Tract 873, Arapahoe County, Colorado",3156,194,399,108,2757,203
1400000US08031000102,8031000102,"Census Tract 1.02, Denver County, Colorado",1534,86,1048,117,486,110
1400000US08031000201,8031000201,"Census Tract 2.01, Denver County, Colorado",1505,82,1161,104,344,89
1400000US08031000202,8031000202,"Census Tract 2.02, Denver County, Colorado",1603,90,985,107,618,103
1400000US08031000301,8031000301,"Census Tract 3.01, Denver County, Colorado",2605,126,1694,168,911,190
1400000US08031000302,8031000302,"Census Tract 3.02, Denver County, Colorado",1959,129,1382,154,577,161
1400000US08031000303,8031000303,"Census Tract 3.03, Denver County, Colorado",2215,143,1229,164,986,184
1400000US08031000401,8031000401,"Census Tract 4.01, Denver County, Colorado",1478,62,826,82,652,100
1400000US08031000402,8031000402,"Census Tract 4.02, Denver County, Colorado",2877,156,1590,198,1287,209
1400000US08031000501,8031000501,"Census Tract 5.01, Denver County, Colorado",974,43,695,64,279,69
1400000US08031000502,8031000502,"Census Tract 5.02, Denver County, Colorado",2750,124,1483,183,1267,176
1400000US08031000600,8031000600,"Census Tract 6, Denver County, Colorado",1253,89,402,94,851,103
1400000US08031000701,8031000701,"Census Tract 7.01, Denver County, Colorado",1758,99,444,94,1314,137
1400000US08031000702,8031000702,"Census Tract 7.02, Denver County, Colorado",2015,103,527,118,1488,124
1400000US08031000800,8031000800,"Census Tract 8, Denver County, Colorado",501,30,15,19,486,35
1400000US08031000902,8031000902,"Census Tract 9.02, Denver County, Colorado",1674,96,1141,111,533,95
1400000US08031000903,8031000903,"Census Tract 9.03, Denver County, Colorado",1909,82,1125,143,784,145
1400000US08031000904,8031000904,"Census Tract 9.04, Denver County, Colorado",1797,82,461,79,1336,102
1400000US08031000905,8031000905,"Census Tract 9.05, Denver County, Colorado",1160,61,561,108,599,105
1400000US08031001000,8031001000,"Census Tract 10, Denver County, Colorado",1165,92,520,104,645,103
1400000US08031001101,8031001101,"Census Tract 11.01, Denver County, Colorado",969,51,515,53,454,68
1400000US08031001102,8031001102,"Census Tract 11.02, Denver County, Colorado",1529,85,670,109,859,112
1400000US08031001301,8031001301,"Census Tract 13.01, Denver County, Colorado",1526,103,904,128,622,119
1400000US08031001302,8031001302,"Census Tract 13.02, Denver County, Colorado",1362,37,844,119,518,115
1400000US08031001401,8031001401,"Census Tract 14.01, Denver County, Colorado",1977,85,995,123,982,131
1400000US08031001402,8031001402,"Census Tract 14.02, Denver County, Colorado",1400,74,751,128,649,124
1400000US08031001403,8031001403,"Census Tract 14.03, Denver County, Colorado",1529,120,439,76,1090,132
1400000US08031001500,8031001500,"Census Tract 15, Denver County, Colorado",1042,85,424,94,618,92
1400000US08031001600,8031001600,"Census Tract 16, Denver County, Colorado",4064,281,1012,248,3052,318
1400000US08031001701,8031001701,"Census Tract 17.01, Denver County, Colorado",3190,188,1134,169,2056,210
1400000US08031001702,8031001702,"Census Tract 17.02, Denver County, Colorado",2298,262,779,170,1519,259
1400000US08031001800,8031001800,"Census Tract 18, Denver County, Colorado",1627,105,397,91,1230,127
1400000US08031001901,8031001901,"Census Tract 19.01, Denver County, Colorado",930,100,183,69,747,107
1400000US08031001902,8031001902,"Census Tract 19.02, Denver County, Colorado",49,25,12,8,37,29
1400000US08031002000,8031002000,"Census Tract 20, Denver County, Colorado",1325,80,325,74,1000,101
1400000US08031002100,8031002100,"Census Tract 21, Denver County, Colorado",2571,132,931,144,1640,195
1400000US08031002300,8031002300,"Census Tract 23, Denver County, Colorado",2142,67,1291,166,851,155
1400000US08031002402,8031002402,"Census Tract 24.02, Denver County, Colorado",822,68,330,60,492,79
1400000US08031002403,8031002403,"Census Tract 24.03, Denver County, Colorado",1991,127,691,116,1300,150
1400000US08031002601,8031002601,"Census Tract 26.01, Denver County, Colorado",2195,134,142,72,2053,147
1400000US08031002602,8031002602,"Census Tract 26.02, Denver County, Colorado",1686,92,390,89,1296,119
1400000US08031002701,8031002701,"Census Tract 27.01, Denver County, Colorado",3442,148,354,104,3088,171
1400000US08031002702,8031002702,"Census Tract 27.02, Denver County, Colorado",3758,166,1367,176,2391,179
1400000US08031002703,8031002703,"Census Tract 27.03, Denver County, Colorado",3358,194,664,148,2694,216
1400000US08031002801,8031002801,"Census Tract 28.01, Denver County, Colorado",1595,86,649,102,946,101
1400000US08031002802,8031002802,"Census Tract 28.02, Denver County, Colorado",2805,114,694,165,2111,187
1400000US08031002803,8031002803,"Census Tract 28.03, Denver County, Colorado",3079,137,629,139,2450,168
1400000US08031002901,8031002901,"Census Tract 29.01, Denver County, Colorado",1487,59,801,100,686,104
1400000US08031002902,8031002902,"Census Tract 29.02, Denver County, Colorado",1974,80,1304,141,670,137
1400000US08031003001,8031003001,"Census Tract 30.01, Denver County, Colorado",2716,148,1813,192,903,189
1400000US08031003002,8031003002,"Census Tract 30.02, Denver County, Colorado",1266,91,609,102,657,119
1400000US08031003003,8031003003,"Census Tract 30.03, Denver County, Colorado",1073,88,415,98,658,117
1400000US08031003004,8031003004,"Census Tract 30.04, Denver County, Colorado",2533,149,1126,201,1407,190
1400000US08031003101,8031003101,"Census Tract 31.01, Denver County, Colorado",732,62,483,65,249,63
1400000US08031003102,8031003102,"Census Tract 31.02, Denver County, Colorado",1738,91,331,70,1407,101
1400000US08031003201,8031003201,"Census Tract 32.01, Denver County, Colorado",3225,217,1145,154,2080,230
1400000US08031003202,8031003202,"Census Tract 32.02, Denver County, Colorado",1896,140,604,106,1292,145
1400000US08031003203,8031003203,"Census Tract 32.03, Denver County, Colorado",1342,58,1090,75,252,63
1400000US08031003300,8031003300,"Census Tract 33, Denver County, Colorado",1483,49,1095,83,388,85
1400000US08031003401,8031003401,"Census Tract 34.01, Denver County, Colorado",1221,92,874,95,347,82
1400000US08031003402,8031003402,"Census Tract 34.02, Denver County, Colorado",2034,79,1552,112,482,102
1400000US08031003500,8031003500,"Census Tract 35, Denver County, Colorado",1763,81,752,116,1011,129
1400000US08031003601,8031003601,"Census Tract 36.01, Denver County, Colorado",1676,80,861,101,815,116
1400000US08031003602,8031003602,"Census Tract 36.02, Denver County, Colorado",1488,97,874,107,614,118
1400000US08031003603,8031003603,"Census Tract 36.03, Denver County, Colorado",1355,91,924,106,431,98
1400000US08031003701,8031003701,"Census Tract 37.01, Denver County, Colorado",1542,119,704,111,838,122
1400000US08031003702,8031003702,"Census Tract 37.02, Denver County, Colorado",2740,100,937,133,1803,151
1400000US08031003703,8031003703,"Census Tract 37.03, Denver County, Colorado",1546,99,669,93,877,115
1400000US08031003800,8031003800,"Census Tract 38, Denver County, Colorado",3942,165,1783,203,2159,238
1400000US08031003901,8031003901,"Census Tract 39.01, Denver County, Colorado",2277,141,1803,178,474,174
1400000US08031003902,8031003902,"Census Tract 39.02, Denver County, Colorado",1827,61,1290,101,537,97
1400000US08031004002,8031004002,"Census Tract 40.02, Denver County, Colorado",1386,51,1204,83,182,67
1400000US08031004003,8031004003,"Census Tract 40.03, Denver County, Colorado",1893,68,1349,117,544,109
1400000US08031004004,8031004004,"Census Tract 40.04, Denver County, Colorado",828,43,756,45,72,29
1400000US08031004005,8031004005,"Census Tract 40.05, Denver County, Colorado",1601,107,407,73,1194,126
1400000US08031004006,8031004006,"Census Tract 40.06, Denver County, Colorado",2049,99,956,111,1093,125
1400000US08031004101,8031004101,"Census Tract 41.01, Denver County, Colorado",1598,76,558,102,1040,114
1400000US08031004102,8031004102,"Census Tract 41.02, Denver County, Colorado",1353,108,758,121,595,116
1400000US08031004103,8031004103,"Census Tract 41.03, Denver County, Colorado",2139,78,1765,129,374,140
1400000US08031004104,8031004104,"Census Tract 41.04, Denver County, Colorado",1862,82,1449,104,413,97
1400000US08031004106,8031004106,"Census Tract 41.06, Denver County, Colorado",2992,117,2455,203,537,183
1400000US08031004107,8031004107,"Census Tract 41.07, Denver County, Colorado",2204,126,1355,162,849,169
1400000US08031004201,8031004201,"Census Tract 42.01, Denver County, Colorado",1975,76,1486,123,489,110
1400000US08031004202,8031004202,"Census Tract 42.02, Denver County, Colorado",1617,83,1446,93,171,79
1400000US08031004301,8031004301,"Census Tract 43.01, Denver County, Colorado",2797,162,974,155,1823,176
1400000US08031004302,8031004302,"Census Tract 43.02, Denver County, Colorado",1217,70,781,101,436,100
1400000US08031004303,8031004303,"Census Tract 43.03, Denver County, Colorado",1582,84,1384,85,198,82
1400000US08031004304,8031004304,"Census Tract 43.04, Denver County, Colorado",2809,88,1866,218,943,191
1400000US08031004306,8031004306,"Census Tract 43.06, Denver County, Colorado",2285,55,1400,122,885,123
1400000US08031004403,8031004403,"Census Tract 44.03, Denver County, Colorado",1646,127,741,103,905,140
1400000US08031004404,8031004404,"Census Tract 44.04, Denver County, Colorado",2427,115,726,129,1701,155
1400000US08031004405,8031004405,"Census Tract 44.05, Denver County, Colorado",3854,170,1855,188,1999,255
1400000US08031004503,8031004503,"Census Tract 45.03, Denver County, Colorado",1254,76,449,135,805,130
1400000US08031004504,8031004504,"Census Tract 45.04, Denver County, Colorado",1084,64,506,132,578,138
1400000US08031004505,8031004505,"Census Tract 45.05, Denver County, Colorado",1255,66,486,90,769,105
1400000US08031004506,8031004506,"Census Tract 45.06, Denver County, Colorado",975,76,291,74,684,96
1400000US08031004601,8031004601,"Census Tract 46.01, Denver County, Colorado",1868,57,1378,110,490,109
1400000US08031004602,8031004602,"Census Tract 46.02, Denver County, Colorado",2229,119,1000,150,1229,156
1400000US08031004603,8031004603,"Census Tract 46.03, Denver County, Colorado",1991,58,1275,104,716,118
1400000US08031004700,8031004700,"Census Tract 47, Denver County, Colorado",2168,113,1221,177,947,182
1400000US08031004801,8031004801,"Census Tract 48.01, Denver County, Colorado",1060,39,979,51,81,40
1400000US08031005001,8031005001,"Census Tract 50.01, Denver County, Colorado",1101,46,834,81,267,78
1400000US08031005002,8031005002,"Census Tract 50.02, Denver County, Colorado",3363,152,1039,131,2324,166
1400000US08031005102,8031005102,"Census Tract 51.02, Denver County, Colorado",1513,84,1101,110,412,94
1400000US08031005104,8031005104,"Census Tract 51.04, Denver County, Colorado",1481,98,314,88,1167,110
1400000US08031005200,8031005200,"Census Tract 52, Denver County, Colorado",1353,73,1155,81,198,78
1400000US08031005300,8031005300,"Census Tract 53, Denver County, Colorado",646,47,298,48,348,61
1400000US08031005502,8031005502,"Census Tract 55.02, Denver County, Colorado",554,47,326,43,228,40
1400000US08031005503,8031005503,"Census Tract 55.03, Denver County, Colorado",1792,68,1615,82,177,75
1400000US08031006701,8031006701,"Census Tract 67.01, Denver County, Colorado",1728,104,181,53,1547,111
1400000US08031006804,8031006804,"Census Tract 68.04, Denver County, Colorado",1255,87,715,71,540,88
1400000US08031006809,8031006809,"Census Tract 68.09, Denver County, Colorado",3530,162,2127,203,1403,202
1400000US08031006810,8031006810,"Census Tract 68.10, Denver County, Colorado",2554,129,1486,178,1068,192
1400000US08031006811,8031006811,"Census Tract 68.11, Denver County, Colorado",3135,143,1472,170,1663,194
1400000US08031006812,8031006812,"Census Tract 68.12, Denver County, Colorado",1728,97,1403,104,325,82
1400000US08031006813,8031006813,"Census Tract 68.13, Denver County, Colorado",2370,160,544,119,1826,185
1400000US08031006814,8031006814,"Census Tract 68.14, Denver County, Colorado",2009,125,1021,122,988,154
1400000US08031006901,8031006901,"Census Tract 69.01, Denver County, Colorado",2626,152,601,114,2025,183
1400000US08031007006,8031007006,"Census Tract 70.06, Denver County, Colorado",2324,154,0,12,2324,154
1400000US08031007013,8031007013,"Census Tract 70.13, Denver County, Colorado",1851,108,1263,129,588,131
1400000US08031007037,8031007037,"Census Tract 70.37, Denver County, Colorado",1695,109,321,81,1374,115
1400000US08031007088,8031007088,"Census Tract 70.88, Denver County, Colorado",2422,130,455,93,1967,168
1400000US08031007089,8031007089,"Census Tract 70.89, Denver County, Colorado",3366,167,2385,222,981,189
1400000US08031008304,8031008304,"Census Tract 83.04, Denver County, Colorado",884,46,594,75,290,67
1400000US08031008305,8031008305,"Census Tract 83.05, Denver County, Colorado",981,58,596,94,385,95
1400000US08031008306,8031008306,"Census Tract 83.06, Denver County, Colorado",1698,87,705,98,993,101
1400000US08031008312,8031008312,"Census Tract 83.12, Denver County, Colorado",2088,73,1218,144,870,146
1400000US08031008386,8031008386,"Census Tract 83.86, Denver County, Colorado",1099,72,898,93,201,75
1400000US08031008387,8031008387,"Census Tract 83.87, Denver County, Colorado",1586,51,1176,155,410,147
1400000US08031008388,8031008388,"Census Tract 83.88, Denver County, Colorado",2662,140,1213,267,1449,270
1400000US08031008389,8031008389,"Census Tract 83.89, Denver County, Colorado",2505,123,2164,177,341,141
1400000US08031008390,8031008390,"Census Tract 83.90, Denver County, Colorado",2740,103,1752,181,988,169
1400000US08031008391,8031008391,"Census Tract 83.91, Denver County, Colorado",2357,81,1871,192,486,190
1400000US08031011902,8031011902,"Census Tract 119.02, Denver County, Colorado",2812,120,1394,167,1418,169
1400000US08031011903,8031011903,"Census Tract 119.03, Denver County, Colorado",941,21,655,61,286,55
1400000US08031012001,8031012001,"Census Tract 120.01, Denver County, Colorado",959,58,672,70,287,67
1400000US08031012010,8031012010,"Census Tract 120.10, Denver County, Colorado",2359,112,1491,149,868,140
1400000US08031012014,8031012014,"Census Tract 120.14, Denver County, Colorado",2860,148,1722,214,1138,215
1400000US08031015300,8031015300,"Census Tract 153, Denver County, Colorado",2144,168,588,158,1556,162
1400000US08031015400,8031015400,"Census Tract 154, Denver County, Colorado",1681,64,1230,88,451,85
1400000US08031015500,8031015500,"Census Tract 155, Denver County, Colorado",1744,73,177,57,1567,92
1400000US08031015600,8031015600,"Census Tract 156, Denver County, Colorado",2124,118,820,155,1304,179
1400000US08031015700,8031015700,"Census Tract 157, Denver County, Colorado",2064,118,1036,151,1028,174
1400000US08031980000,8031980000,"Census Tract 9800, Denver County, Colorado",503,78,315,81,188,68
1400000US08031980100,8031980100,"Census Tract 9801, Denver County, Colorado",0,12,0,12,0,12
1400000US08035013901,8035013901,"Census Tract 139.01, Douglas County, Colorado",2679,104,2079,128,600,125
1400000US08035013904,8035013904,"Census Tract 139.04, Douglas County, Colorado",1715,97,946,101,769,108
1400000US08035013905,8035013905,"Census Tract 139.05, Douglas County, Colorado",1345,88,948,94,397,92
1400000US08035013907,8035013907,"Census Tract 139.07, Douglas County, Colorado",1859,74,1609,116,250,95
1400000US08035013908,8035013908,"Census Tract 139.08, Douglas County, Colorado",2364,101,2190,145,174,103
1400000US08035013909,8035013909,"Census Tract 139.09, Douglas County, Colorado",2191,73,2148,80,43,39
1400000US08035013910,8035013910,"Census Tract 139.10, Douglas County, Colorado",2061,62,1934,96,127,76
1400000US08035013911,8035013911,"Census Tract 139.11, Douglas County, Colorado",2057,98,1882,170,175,127
1400000US08035014001,8035014001,"Census Tract 140.01, Douglas County, Colorado",2541,161,2156,193,385,149
1400000US08035014005,8035014005,"Census Tract 140.05, Douglas County, Colorado",1704,63,1499,112,205,93
1400000US08035014006,8035014006,"Census Tract 140.06, Douglas County, Colorado",1976,113,1867,140,109,84
1400000US08035014007,8035014007,"Census Tract 140.07, Douglas County, Colorado",1186,118,293,88,893,120
1400000US08035014008,8035014008,"Census Tract 140.08, Douglas County, Colorado",2107,142,1931,170,176,121
1400000US08035014009,8035014009,"Census Tract 140.09, Douglas County, Colorado",1148,67,1061,79,87,55
1400000US08035014010,8035014010,"Census Tract 140.10, Douglas County, Colorado",2015,116,1320,105,695,132
1400000US08035014011,8035014011,"Census Tract 140.11, Douglas County, Colorado",933,99,399,65,534,118
1400000US08035014012,8035014012,"Census Tract 140.12, Douglas County, Colorado",2669,126,2083,195,586,173
1400000US08035014013,8035014013,"Census Tract 140.13, Douglas County, Colorado",1281,67,1189,94,92,62
1400000US08035014107,8035014107,"Census Tract 141.07, Douglas County, Colorado",1303,82,1268,87,35,31
1400000US08035014108,8035014108,"Census Tract 141.08, Douglas County, Colorado",1796,55,1609,92,187,78
1400000US08035014109,8035014109,"Census Tract 141.09, Douglas County, Colorado",1022,83,831,71,191,47
1400000US08035014110,8035014110,"Census Tract 141.10, Douglas County, Colorado",2209,109,1332,148,877,160
1400000US08035014112,8035014112,"Census Tract 141.12, Douglas County, Colorado",1443,54,1203,95,240,89
1400000US08035014113,8035014113,"Census Tract 141.13, Douglas County, Colorado",993,36,914,47,79,38
1400000US08035014114,8035014114,"Census Tract 141.14, Douglas County, Colorado",1392,43,947,111,445,110
1400000US08035014115,8035014115,"Census Tract 141.15, Douglas County, Colorado",1694,121,1300,160,394,98
1400000US08035014116,8035014116,"Census Tract 141.16, Douglas County, Colorado",2140,148,649,92,1491,128
1400000US08035014122,8035014122,"Census Tract 141.22, Douglas County, Colorado",2424,132,1899,162,525,123
1400000US08035014123,8035014123,"Census Tract 141.23, Douglas County, Colorado",1145,102,570,71,575,102
1400000US08035014124,8035014124,"Census Tract 141.24, Douglas County, Colorado",1687,95,1553,98,134,66
1400000US08035014125,8035014125,"Census Tract 141.25, Douglas County, Colorado",1038,105,890,101,148,52
1400000US08035014126,8035014126,"Census Tract 141.26, Douglas County, Colorado",825,79,281,60,544,88
1400000US08035014127,8035014127,"Census Tract 141.27, Douglas County, Colorado",1826,112,1715,136,111,90
1400000US08035014128,8035014128,"Census Tract 141.28, Douglas County, Colorado",1818,50,1574,111,244,90
1400000US08035014129,8035014129,"Census Tract 141.29, Douglas County, Colorado",1205,46,1123,57,82,42
1400000US08035014130,8035014130,"Census Tract 141.30, Douglas County, Colorado",2449,41,2298,101,151,92
1400000US08035014131,8035014131,"Census Tract 141.31, Douglas County, Colorado",1740,85,884,105,856,112
1400000US08035014132,8035014132,"Census Tract 141.32, Douglas County, Colorado",1789,46,1661,79,128,75
1400000US08035014133,8035014133,"Census Tract 141.33, Douglas County, Colorado",2148,96,1997,122,151,88
1400000US08035014134,8035014134,"Census Tract 141.34, Douglas County, Colorado",1932,59,1675,103,257,88
1400000US08035014135,8035014135,"Census Tract 141.35, Douglas County, Colorado",887,83,866,82,21,21
1400000US08035014136,8035014136,"Census Tract 141.36, Douglas County, Colorado",2853,109,2184,176,669,149
1400000US08035014137,8035014137,"Census Tract 141.37, Douglas County, Colorado",2913,89,2706,134,207,98
1400000US08035014138,8035014138,"Census Tract 141.38, Douglas County, Colorado",1718,95,447,118,1271,113
1400000US08035014139,8035014139,"Census Tract 141.39, Douglas County, Colorado",1535,97,1326,116,209,91
1400000US08035014140,8035014140,"Census Tract 141.40, Douglas County, Colorado",1828,49,1685,106,143,80
1400000US08035014202,8035014202,"Census Tract 142.02, Douglas County, Colorado",661,56,641,61,20,17
1400000US08035014203,8035014203,"Census Tract 142.03, Douglas County, Colorado",2225,117,2158,130,67,54
1400000US08035014204,8035014204,"Census Tract 142.04, Douglas County, Colorado",993,98,898,105,95,64
1400000US08035014300,8035014300,"Census Tract 143, Douglas County, Colorado",323,51,273,47,50,28
1400000US08035014403,8035014403,"Census Tract 144.03, Douglas County, Colorado",1922,129,1612,109,310,104
1400000US08035014404,8035014404,"Census Tract 144.04, Douglas County, Colorado",988,67,930,71,58,36
1400000US08035014405,8035014405,"Census Tract 144.05, Douglas County, Colorado",2516,86,2346,133,170,94
1400000US08035014406,8035014406,"Census Tract 144.06, Douglas County, Colorado",2933,109,2568,184,365,150
1400000US08035014503,8035014503,"Census Tract 145.03, Douglas County, Colorado",2077,114,1478,125,599,140
1400000US08035014504,8035014504,"Census Tract 145.04, Douglas County, Colorado",1750,103,1104,101,646,122
1400000US08035014505,8035014505,"Census Tract 145.05, Douglas County, Colorado",1773,99,1158,130,615,112
1400000US08035014506,8035014506,"Census Tract 145.06, Douglas County, Colorado",1214,99,1155,108,59,46
1400000US08035014602,8035014602,"Census Tract 146.02, Douglas County, Colorado",864,48,770,71,94,62
1400000US08035014603,8035014603,"Census Tract 146.03, Douglas County, Colorado",2274,70,1841,198,433,186
1400000US08035014604,8035014604,"Census Tract 146.04, Douglas County, Colorado",1308,87,1187,126,121,86
1400000US08059009806,8059009806,"Census Tract 98.06, Jefferson County, Colorado",1450,64,1322,82,128,65
1400000US08059009807,8059009807,"Census Tract 98.07, Jefferson County, Colorado",767,61,539,50,228,61
1400000US08059009808,8059009808,"Census Tract 98.08, Jefferson County, Colorado",2410,173,1775,137,635,139
1400000US08059009815,8059009815,"Census Tract 98.15, Jefferson County, Colorado",1872,67,1647,71,225,78
1400000US08059009823,8059009823,"Census Tract 98.23, Jefferson County, Colorado",1694,92,1418,103,276,90
1400000US08059009824,8059009824,"Census Tract 98.24, Jefferson County, Colorado",1816,70,1444,106,372,89
1400000US08059009827,8059009827,"Census Tract 98.27, Jefferson County, Colorado",2263,138,1482,150,781,169
1400000US08059009828,8059009828,"Census Tract 98.28, Jefferson County, Colorado",2056,118,1552,118,504,143
1400000US08059009829,8059009829,"Census Tract 98.29, Jefferson County, Colorado",664,24,616,38,48,29
1400000US08059009830,8059009830,"Census Tract 98.30, Jefferson County, Colorado",972,62,741,72,231,64
1400000US08059009831,8059009831,"Census Tract 98.31, Jefferson County, Colorado",1226,80,0,12,1226,80
1400000US08059009832,8059009832,"Census Tract 98.32, Jefferson County, Colorado",927,38,769,54,158,49
1400000US08059009833,8059009833,"Census Tract 98.33, Jefferson County, Colorado",2460,61,1803,152,657,138
1400000US08059009834,8059009834,"Census Tract 98.34, Jefferson County, Colorado",1969,83,1429,97,540,108
1400000US08059009835,8059009835,"Census Tract 98.35, Jefferson County, Colorado",1439,25,1355,52,84,52
1400000US08059009836,8059009836,"Census Tract 98.36, Jefferson County, Colorado",1395,24,1338,51,57,42
1400000US08059009837,8059009837,"Census Tract 98.37, Jefferson County, Colorado",922,40,903,43,19,19
1400000US08059009838,8059009838,"Census Tract 98.38, Jefferson County, Colorado",1597,46,1575,47,22,17
1400000US08059009839,8059009839,"Census Tract 98.39, Jefferson County, Colorado",818,31,783,39,35,23
1400000US08059009840,8059009840,"Census Tract 98.40, Jefferson County, Colorado",1511,62,1166,87,345,71
1400000US08059009841,8059009841,"Census Tract 98.41, Jefferson County, Colorado",868,20,739,69,129,62
1400000US08059009842,8059009842,"Census Tract 98.42, Jefferson County, Colorado",1059,97,990,103,69,62
1400000US08059009843,8059009843,"Census Tract 98.43, Jefferson County, Colorado",3080,133,2300,180,780,201
1400000US08059009845,8059009845,"Census Tract 98.45, Jefferson County, Colorado",1722,80,1568,93,154,69
1400000US08059009846,8059009846,"Census Tract 98.46, Jefferson County, Colorado",1861,114,1710,121,151,85
1400000US08059009847,8059009847,"Census Tract 98.47, Jefferson County, Colorado",1271,81,1036,85,235,100
1400000US08059009848,8059009848,"Census Tract 98.48, Jefferson County, Colorado",943,83,716,79,227,72
1400000US08059009849,8059009849,"Census Tract 98.49, Jefferson County, Colorado",2461,146,1629,195,832,142
1400000US08059009850,8059009850,"Census Tract 98.50, Jefferson County, Colorado",996,80,895,101,101,61
1400000US08059009851,8059009851,"Census Tract 98.51, Jefferson County, Colorado",1519,73,1479,78,40,33
1400000US08059009852,8059009852,"Census Tract 98.52, Jefferson County, Colorado",1440,64,1239,99,201,83
1400000US08059009900,8059009900,"Census Tract 99, Jefferson County, Colorado",1130,84,589,93,541,88
1400000US08059010000,8059010000,"Census Tract 100, Jefferson County, Colorado",1263,102,412,83,851,105
1400000US08059010100,8059010100,"Census Tract 101, Jefferson County, Colorado",2125,89,918,128,1207,150
1400000US08059010205,8059010205,"Census Tract 102.05, Jefferson County, Colorado",967,38,799,50,168,46
1400000US08059010206,8059010206,"Census Tract 102.06, Jefferson County, Colorado",1660,55,1283,99,377,99
1400000US08059010208,8059010208,"Census Tract 102.08, Jefferson County, Colorado",2133,74,1744,132,389,120
1400000US08059010209,8059010209,"Census Tract 102.09, Jefferson County, Colorado",2465,121,1790,137,675,144
1400000US08059010210,8059010210,"Census Tract 102.10, Jefferson County, Colorado",1358,62,1148,87,210,75
1400000US08059010211,8059010211,"Census Tract 102.11, Jefferson County, Colorado",1490,38,733,88,757,89
1400000US08059010212,8059010212,"Census Tract 102.12, Jefferson County, Colorado",1783,60,1203,107,580,112
1400000US08059010213,8059010213,"Census Tract 102.13, Jefferson County, Colorado",1800,108,1229,123,571,123
1400000US08059010303,8059010303,"Census Tract 103.03, Jefferson County, Colorado",2226,76,1604,134,622,118
1400000US08059010304,8059010304,"Census Tract 103.04, Jefferson County, Colorado",1076,53,787,89,289,86
1400000US08059010305,8059010305,"Census Tract 103.05, Jefferson County, Colorado",1607,80,971,98,636,119
1400000US08059010306,8059010306,"Census Tract 103.06, Jefferson County, Colorado",1132,23,787,82,345,81
1400000US08059010307,8059010307,"Census Tract 103.07, Jefferson County, Colorado",2094,59,836,111,1258,128
1400000US08059010308,8059010308,"Census Tract 103.08, Jefferson County, Colorado",2354,65,1566,136,788,133
1400000US08059010402,8059010402,"Census Tract 104.02, Jefferson County, Colorado",2603,101,1064,217,1539,229
1400000US08059010403,8059010403,"Census Tract 104.03, Jefferson County, Colorado",2349,143,734,148,1615,211
1400000US08059010405,8059010405,"Census Tract 104.05, Jefferson County, Colorado",1377,67,206,61,1171,82
1400000US08059010406,8059010406,"Census Tract 104.06, Jefferson County, Colorado",991,47,620,76,371,83
1400000US08059010502,8059010502,"Census Tract 105.02, Jefferson County, Colorado",2230,124,1532,149,698,141
1400000US08059010503,8059010503,"Census Tract 105.03, Jefferson County, Colorado",1949,115,1278,106,671,118
1400000US08059010504,8059010504,"Census Tract 105.04, Jefferson County, Colorado",1188,74,1145,81,43,26
1400000US08059010603,8059010603,"Census Tract 106.03, Jefferson County, Colorado",1717,71,879,101,838,96
1400000US08059010604,8059010604,"Census Tract 106.04, Jefferson County, Colorado",1040,83,554,94,486,106
1400000US08059010701,8059010701,"Census Tract 107.01, Jefferson County, Colorado",2086,97,1167,132,919,129
1400000US08059010702,8059010702,"Census Tract 107.02, Jefferson County, Colorado",2206,152,818,136,1388,144
1400000US08059010801,8059010801,"Census Tract 108.01, Jefferson County, Colorado",1066,51,924,72,142,66
1400000US08059010901,8059010901,"Census Tract 109.01, Jefferson County, Colorado",1968,120,1277,153,691,155
1400000US08059010902,8059010902,"Census Tract 109.02, Jefferson County, Colorado",1091,77,324,76,767,81
1400000US08059011000,8059011000,"Census Tract 110, Jefferson County, Colorado",2253,130,1057,133,1196,159
1400000US08059011100,8059011100,"Census Tract 111, Jefferson County, Colorado",2773,87,1124,129,1649,145
1400000US08059011202,8059011202,"Census Tract 112.02, Jefferson County, Colorado",1625,91,1233,121,392,106
1400000US08059011300,8059011300,"Census Tract 113, Jefferson County, Colorado",1386,156,704,134,682,131
1400000US08059011401,8059011401,"Census Tract 114.01, Jefferson County, Colorado",1084,97,378,97,706,115
1400000US08059011402,8059011402,"Census Tract 114.02, Jefferson County, Colorado",1909,96,516,128,1393,174
1400000US08059011550,8059011550,"Census Tract 115.50, Jefferson County, Colorado",2626,171,873,180,1753,229
1400000US08059011601,8059011601,"Census Tract 116.01, Jefferson County, Colorado",1383,88,680,90,703,110
1400000US08059011602,8059011602,"Census Tract 116.02, Jefferson County, Colorado",1622,65,1045,136,577,138
1400000US08059011701,8059011701,"Census Tract 117.01, Jefferson County, Colorado",2021,46,1477,113,544,112
1400000US08059011702,8059011702,"Census Tract 117.02, Jefferson County, Colorado",2230,67,1730,132,500,116
1400000US08059011708,8059011708,"Census Tract 117.08, Jefferson County, Colorado",1578,73,1359,95,219,86
1400000US08059011709,8059011709,"Census Tract 117.09, Jefferson County, Colorado",1529,62,850,103,679,94
1400000US08059011710,8059011710,"Census Tract 117.10, Jefferson County, Colorado",1679,123,990,107,689,111
1400000US08059011711,8059011711,"Census Tract 117.11, Jefferson County, Colorado",1739,92,1150,98,589,114
1400000US08059011712,8059011712,"Census Tract 117.12, Jefferson County, Colorado",1771,53,1658,79,113,61
1400000US08059011720,8059011720,"Census Tract 117.20, Jefferson County, Colorado",1995,79,1753,101,242,87
1400000US08059011721,8059011721,"Census Tract 117.21, Jefferson County, Colorado",1202,74,831,97,371,86
1400000US08059011723,8059011723,"Census Tract 117.23, Jefferson County, Colorado",1606,74,609,75,997,108
1400000US08059011724,8059011724,"Census Tract 117.24, Jefferson County, Colorado",1583,74,1514,85,69,39
1400000US08059011725,8059011725,"Census Tract 117.25, Jefferson County, Colorado",668,31,621,42,47,28
1400000US08059011726,8059011726,"Census Tract 117.26, Jefferson County, Colorado",2182,101,2131,99,51,41
1400000US08059011727,8059011727,"Census Tract 117.27, Jefferson County, Colorado",1477,51,1279,82,198,75
1400000US08059011728,8059011728,"Census Tract 117.28, Jefferson County, Colorado",1112,32,1010,59,102,47
1400000US08059011729,8059011729,"Census Tract 117.29, Jefferson County, Colorado",1956,73,949,101,1007,109
1400000US08059011730,8059011730,"Census Tract 117.30, Jefferson County, Colorado",1660,75,960,132,700,135
1400000US08059011731,8059011731,"Census Tract 117.31, Jefferson County, Colorado",1980,85,860,90,1120,108
1400000US08059011732,8059011732,"Census Tract 117.32, Jefferson County, Colorado",2565,114,386,106,2179,143
1400000US08059011733,8059011733,"Census Tract 117.33, Jefferson County, Colorado",681,43,296,55,385,69
1400000US08059011803,8059011803,"Census Tract 118.03, Jefferson County, Colorado",1966,58,1436,104,530,105
1400000US08059011804,8059011804,"Census Tract 118.04, Jefferson County, Colorado",1540,65,1163,113,377,105
1400000US08059011805,8059011805,"Census Tract 118.05, Jefferson County, Colorado",2523,154,367,105,2156,185
1400000US08059011806,8059011806,"Census Tract 118.06, Jefferson County, Colorado",2124,112,1290,139,834,165
1400000US08059011904,8059011904,"Census Tract 119.04, Jefferson County, Colorado",1064,57,639,91,425,87
1400000US08059011951,8059011951,"Census Tract 119.51, Jefferson County, Colorado",1353,65,1083,93,270,75
1400000US08059012022,8059012022,"Census Tract 120.22, Jefferson County, Colorado",2312,46,1793,147,519,144
1400000US08059012023,8059012023,"Census Tract 120.23, Jefferson County, Colorado",1296,61,1219,78,77,49
1400000US08059012024,8059012024,"Census Tract 120.24, Jefferson County, Colorado",1925,50,1786,83,139,74
1400000US08059012026,8059012026,"Census Tract 120.26, Jefferson County, Colorado",1574,90,1123,122,451,127
1400000US08059012027,8059012027,"Census Tract 120.27, Jefferson County, Colorado",1206,81,943,94,263,79
1400000US08059012030,8059012030,"Census Tract 120.30, Jefferson County, Colorado",1595,81,1297,111,298,101
1400000US08059012031,8059012031,"Census Tract 120.31, Jefferson County, Colorado",1451,96,1354,117,97,71
1400000US08059012032,8059012032,"Census Tract 120.32, Jefferson County, Colorado",992,69,932,73,60,29
1400000US08059012033,8059012033,"Census Tract 120.33, Jefferson County, Colorado",1156,85,1104,84,52,35
1400000US08059012034,8059012034,"Census Tract 120.34, Jefferson County, Colorado",1344,63,1294,77,50,49
1400000US08059012035,8059012035,"Census Tract 120.35, Jefferson County, Colorado",1858,40,1800,68,58,58
1400000US08059012036,8059012036,"Census Tract 120.36, Jefferson County, Colorado",1369,67,1331,72,38,30
1400000US08059012037,8059012037,"Census Tract 120.37, Jefferson County, Colorado",1377,106,1238,109,139,67
1400000US08059012038,8059012038,"Census Tract 120.38, Jefferson County, Colorado",1251,46,1142,67,109,57
1400000US08059012039,8059012039,"Census Tract 120.39, Jefferson County, Colorado",2019,60,1697,116,322,102
1400000US08059012041,8059012041,"Census Tract 120.41, Jefferson County, Colorado",1919,144,1709,158,210,103
1400000US08059012042,8059012042,"Census Tract 120.42, Jefferson County, Colorado",1400,44,1299,69,101,55
1400000US08059012043,8059012043,"Census Tract 120.43, Jefferson County, Colorado",2037,70,1793,96,244,89
1400000US08059012044,8059012044,"Census Tract 120.44, Jefferson County, Colorado",1484,78,828,115,656,102
1400000US08059012045,8059012045,"Census Tract 120.45, Jefferson County, Colorado",2233,58,1961,124,272,115
1400000US08059012046,8059012046,"Census Tract 120.46, Jefferson County, Colorado",852,39,793,53,59,37
1400000US08059012047,8059012047,"Census Tract 120.47, Jefferson County, Colorado",1581,79,1208,105,373,103
1400000US08059012048,8059012048,"Census Tract 120.48, Jefferson County, Colorado",1093,36,817,55,276,60
1400000US08059012049,8059012049,"Census Tract 120.49, Jefferson County, Colorado",1277,70,1252,73,25,23
1400000US08059012050,8059012050,"Census Tract 120.50, Jefferson County, Colorado",1668,88,776,79,892,97
1400000US08059012051,8059012051,"Census Tract 120.51, Jefferson County, Colorado",1298,30,1264,41,34,27
1400000US08059012052,8059012052,"Census Tract 120.52, Jefferson County, Colorado",2058,92,1728,126,330,101
1400000US08059012053,8059012053,"Census Tract 120.53, Jefferson County, Colorado",1463,26,1379,51,84,45
1400000US08059012054,8059012054,"Census Tract 120.54, Jefferson County, Colorado",1560,79,1328,62,232,73
1400000US08059012055,8059012055,"Census Tract 120.55, Jefferson County, Colorado",1593,52,1391,98,202,92
1400000US08059012057,8059012057,"Census Tract 120.57, Jefferson County, Colorado",2563,95,2011,179,552,170
1400000US08059012058,8059012058,"Census Tract 120.58, Jefferson County, Colorado",1557,103,1351,99,206,77
1400000US08059012059,8059012059,"Census Tract 120.59, Jefferson County, Colorado",1143,63,851,66,292,75
1400000US08059012060,8059012060,"Census Tract 120.60, Jefferson County, Colorado",1313,71,1148,104,165,91
1400000US08059015800,8059015800,"Census Tract 158, Jefferson County, Colorado",1727,86,759,103,968,127
1400000US08059015900,8059015900,"Census Tract 159, Jefferson County, Colorado",1360,69,467,60,893,80
1400000US08059060300,8059060300,"Census Tract 603, Jefferson County, Colorado",1559,68,1412,88,147,67
1400000US08059060400,8059060400,"Census Tract 604, Jefferson County, Colorado",1225,40,1057,80,168,70
1400000US08059060500,8059060500,"Census Tract 605, Jefferson County, Colorado",1709,111,1191,120,518,119
1400000US08059980000,8059980000,"Census Tract 9800, Jefferson County, Colorado",0,12,0,12,0,12
1400000US08059980400,8059980400,"Census Tract 9804, Jefferson County, Colorado",0,12,0,12,0,12
