GEO.id,GEO.id2,GEO.display-label,HD01_VD01,HD02_VD01,HD01_VD02,HD02_VD02,HD01_VD03,HD02_VD03
1400000US08001007801,8001007801,"Census Tract 78.01, Adams County, Colorado",1261,57,1166,81,95,64
1400000US08001007802,8001007802,"Census Tract 78.02, Adams County, Colorado",1427,67,1187,103,240,112
1400000US08001007900,8001007900,"Census Tract 79, Adams County, Colorado",1904,76,1750,97,154,79
1400000US08001008000,8001008000,"Census Tract 80, Adams County, Colorado",1810,82,1762,76,48,51
1400000US08001008100,8001008100,"Census Tract 81, Adams County, Colorado",566,55,514,61,52,34
1400000US08001008200,8001008200,"Census Tract 82, Adams County, Colorado",1479,66,1452,69,27,43
1400000US08001008308,8001008308,"Census Tract 83.08, Adams County, Colorado",1828,121,1752,134,76,79
1400000US08001008309,8001008309,"Census Tract 83.09, Adams County, Colorado",1106,65,1056,69,50,55
1400000US08001008353,8001008353,"Census Tract 83.53, Adams County, Colorado",2247,112,2016,141,231,121
1400000US08001008401,8001008401,"Census Tract 84.01, Adams County, Colorado",1661,105,1603,115,58,46
1400000US08001008402,8001008402,"Census Tract 84.02, Adams County, Colorado",1686,69,1567,94,119,69
1400000US08001008505,8001008505,"Census Tract 85.05, Adams County, Colorado",2620,103,2519,134,101,103
1400000US08001008506,8001008506,"Census Tract 85.06, Adams County, Colorado",2848,121,2606,191,242,146
1400000US08001008507,8001008507,"Census Tract 85.07, Adams County, Colorado",2260,91,2176,124,84,89
1400000US08001008508,8001008508,"Census Tract 85.08, Adams County, Colorado",1956,59,1834,91,122,79
1400000US08001008523,8001008523,"Census Tract 85.23, Adams County, Colorado",2728,108,2554,133,174,109
1400000US08001008524,8001008524,"Census Tract 85.24, Adams County, Colorado",2555,67,2512,99,43,65
1400000US08001008526,8001008526,"Census Tract 85.26, Adams County, Colorado",2476,67,2449,69,27,44
1400000US08001008529,8001008529,"Census Tract 85.29, Adams County, Colorado",3338,89,3058,179,280,181
1400000US08001008533,8001008533,"Census Tract 85.33, Adams County, Colorado",3247,75,3074,146,173,128
1400000US08001008534,8001008534,"Census Tract 85.34, Adams County, Colorado",1418,39,1399,51,19,27
1400000US08001008535,8001008535,"Census Tract 85.35, Adams County, Colorado",1249,44,1203,76,46,58
1400000US08001008536,8001008536,"Census Tract 85.36, Adams County, Colorado",874,68,832,84,42,39
1400000US08001008537,8001008537,"Census Tract 85.37, Adams County, Colorado",1953,76,1737,179,216,170
1400000US08001008538,8001008538,"Census Tract 85.38, Adams County, Colorado",1968,96,1930,104,38,45
1400000US08001008539,8001008539,"Census Tract 85.39, Adams County, Colorado",2851,130,2773,143,78,97
1400000US08001008540,8001008540,"Census Tract 85.40, Adams County, Colorado",2340,100,2289,130,51,70
1400000US08001008541,8001008541,"Census Tract 85.41, Adams County, Colorado",1605,101,1581,103,24,38
1400000US08001008542,8001008542,"Census Tract 85.42, Adams County, Colorado",2277,123,2198,143,79,89
1400000US08001008543,8001008543,"Census Tract 85.43, Adams County, Colorado",2514,123,2469,149,45,73
1400000US08001008544,8001008544,"Census Tract 85.44, Adams County, Colorado",1484,37,1373,100,111,100
1400000US08001008545,8001008545,"Census Tract 85.45, Adams County, Colorado",2231,57,2179,78,52,62
1400000US08001008546,8001008546,"Census Tract 85.46, Adams County, Colorado",1088,31,1048,64,40,52
1400000US08001008547,8001008547,"Census Tract 85.47, Adams County, Colorado",1185,46,1156,53,29,34
1400000US08001008548,8001008548,"Census Tract 85.48, Adams County, Colorado",533,48,526,48,7,10
1400000US08001008549,8001008549,"Census Tract 85.49, Adams County, Colorado",1360,41,1330,66,30,47
1400000US08001008550,8001008550,"Census Tract 85.50, Adams County, Colorado",2686,93,2557,129,129,108
1400000US08001008551,8001008551,"Census Tract 85.51, Adams County, Colorado",335,36,335,36,0,12
1400000US08001008603,8001008603,"Census Tract 86.03, Adams County, Colorado",801,37,769,49,32,39
1400000US08001008604,8001008604,"Census Tract 86.04, Adams County, Colorado",1169,60,1169,60,0,17
1400000US08001008605,8001008605,"Census Tract 86.05, Adams County, Colorado",1370,68,1305,74,65,45
1400000US08001008606,8001008606,"Census Tract 86.06, Adams County, Colorado",2307,83,2172,116,135,109
1400000US08001008705,8001008705,"Census Tract 87.05, Adams County, Colorado",1679,61,1467,102,212,95
1400000US08001008706,8001008706,"Census Tract 87.06, Adams County, Colorado",1741,63,1546,112,195,105
1400000US08001008709,8001008709,"Census Tract 87.09, Adams County, Colorado",2575,107,2409,169,166,130
1400000US08001008801,8001008801,"Census Tract 88.01, Adams County, Colorado",1523,60,1421,89,102,72
1400000US08001008802,8001008802,"Census Tract 88.02, Adams County, Colorado",1258,66,1201,76,57,52
1400000US08001008901,8001008901,"Census Tract 89.01, Adams County, Colorado",787,24,728,45,59,44
1400000US08001009001,8001009001,"Census Tract 90.01, Adams County, Colorado",1580,40,1500,65,80,60
1400000US08001009002,8001009002,"Census Tract 90.02, Adams County, Colorado",3391,96,3192,146,199,108
1400000US08001009101,8001009101,"Census Tract 91.01, Adams County, Colorado",1397,48,1326,76,71,61
1400000US08001009103,8001009103,"Census Tract 91.03, Adams County, Colorado",1062,88,997,89,65,57
1400000US08001009104,8001009104,"Census Tract 91.04, Adams County, Colorado",1851,78,1715,102,136,82
1400000US08001009202,8001009202,"Census Tract 92.02, Adams County, Colorado",1407,56,1320,75,87,59
1400000US08001009203,8001009203,"Census Tract 92.03, Adams County, Colorado",1705,56,1446,117,259,100
1400000US08001009204,8001009204,"Census Tract 92.04, Adams County, Colorado",2574,93,2434,150,140,113
1400000US08001009206,8001009206,"Census Tract 92.06, Adams County, Colorado",792,56,792,56,0,12
1400000US08001009207,8001009207,"Census Tract 92.07, Adams County, Colorado",1598,55,1568,73,30,48
1400000US08001009304,8001009304,"Census Tract 93.04, Adams County, Colorado",2220,76,2176,89,44,54
1400000US08001009306,8001009306,"Census Tract 93.06, Adams County, Colorado",1265,41,1197,74,68,60
1400000US08001009307,8001009307,"Census Tract 93.07, Adams County, Colorado",1302,42,1215,78,87,73
1400000US08001009308,8001009308,"Census Tract 93.08, Adams County, Colorado",1451,45,1331,86,120,77
1400000US08001009309,8001009309,"Census Tract 93.09, Adams County, Colorado",1487,40,1342,98,145,89
1400000US08001009310,8001009310,"Census Tract 93.10, Adams County, Colorado",2033,55,1947,86,86,68
1400000US08001009316,8001009316,"Census Tract 93.16, Adams County, Colorado",2152,152,2010,158,142,116
1400000US08001009318,8001009318,"Census Tract 93.18, Adams County, Colorado",2278,86,2167,129,111,83
1400000US08001009319,8001009319,"Census Tract 93.19, Adams County, Colorado",978,78,855,89,123,58
1400000US08001009320,8001009320,"Census Tract 93.20, Adams County, Colorado",1248,58,1108,87,140,79
1400000US08001009321,8001009321,"Census Tract 93.21, Adams County, Colorado",1512,119,1418,119,94,71
1400000US08001009322,8001009322,"Census Tract 93.22, Adams County, Colorado",1571,108,1394,110,177,108
1400000US08001009323,8001009323,"Census Tract 93.23, Adams County, Colorado",1605,66,1518,87,87,71
1400000US08001009325,8001009325,"Census Tract 93.25, Adams County, Colorado",2514,69,2202,182,312,181
1400000US08001009326,8001009326,"Census Tract 93.26, Adams County, Colorado",1132,38,1066,75,66,63
1400000US08001009327,8001009327,"Census Tract 93.27, Adams County, Colorado",1710,73,1608,112,102,90
1400000US08001009401,8001009401,"Census Tract 94.01, Adams County, Colorado",1889,40,1819,62,70,55
1400000US08001009406,8001009406,"Census Tract 94.06, Adams County, Colorado",1755,60,1755,60,0,12
1400000US08001009407,8001009407,"Census Tract 94.07, Adams County, Colorado",1830,41,1755,80,75,75
1400000US08001009408,8001009408,"Census Tract 94.08, Adams County, Colorado",1779,56,1670,83,109,70
1400000US08001009409,8001009409,"Census Tract 94.09, Adams County, Colorado",2271,79,2133,121,138,104
1400000US08001009410,8001009410,"Census Tract 94.10, Adams County, Colorado",1258,66,1180,70,78,64
1400000US08001009411,8001009411,"Census Tract 94.11, Adams County, Colorado",1259,42,1228,63,31,47
1400000US08001009501,8001009501,"Census Tract 95.01, Adams County, Colorado",1182,33,1130,62,52,56
1400000US08001009502,8001009502,"Census Tract 95.02, Adams County, Colorado",1322,38,1289,62,33,51
1400000US08001009553,8001009553,"Census Tract 95.53, Adams County, Colorado",1179,37,1059,84,120,76
1400000US08001009603,8001009603,"Census Tract 96.03, Adams County, Colorado",2426,63,2159,140,267,128
1400000US08001009604,8001009604,"Census Tract 96.04, Adams County, Colorado",2056,74,1934,107,122,84
1400000US08001009606,8001009606,"Census Tract 96.06, Adams County, Colorado",1139,36,995,100,144,91
1400000US08001009607,8001009607,"Census Tract 96.07, Adams County, Colorado",2001,42,1788,94,213,92
1400000US08001009608,8001009608,"Census Tract 96.08, Adams County, Colorado",1279,146,1224,147,55,66
1400000US08001009751,8001009751,"Census Tract 97.51, Adams County, Colorado",1450,45,1366,85,84,68
1400000US08001009752,8001009752,"Census Tract 97.52, Adams County, Colorado",1089,37,1084,37,5,8
1400000US08001015000,8001015000,"Census Tract 150, Adams County, Colorado",1146,40,1062,80,84,60
1400000US08001060000,8001060000,"Census Tract 600, Adams County, Colorado",1571,30,1514,82,57,75
1400000US08001060100,8001060100,"Census Tract 601, Adams County, Colorado",2241,133,2205,134,36,57
1400000US08001060200,8001060200,"Census Tract 602, Adams County, Colorado",1868,55,1730,107,138,97
1400000US08001061200,8001061200,"Census Tract 612, Adams County, Colorado",415,42,415,42,0,12
1400000US08001988700,8001988700,"Census Tract 9887, Adams County, Colorado",0,12,0,12,0,12
1400000US08005004951,8005004951,"Census Tract 49.51, Arapahoe County, Colorado",1169,98,1048,94,121,82
1400000US08005004952,8005004952,"Census Tract 49.52, Arapahoe County, Colorado",1552,159,1453,151,99,64
1400000US08005005551,8005005551,"Census Tract 55.51, Arapahoe County, Colorado",1140,67,1140,67,0,12
1400000US08005005552,8005005552,"Census Tract 55.52, Arapahoe County, Colorado",1107,124,1049,126,58,59
1400000US08005005553,8005005553,"Census Tract 55.53, Arapahoe County, Colorado",1503,60,1400,86,103,76
1400000US08005005611,8005005611,"Census Tract 56.11, Arapahoe County, Colorado",1989,54,1887,81,102,68
1400000US08005005612,8005005612,"Census Tract 56.12, Arapahoe County, Colorado",1529,55,1513,57,16,18
1400000US08005005614,8005005614,"Census Tract 56.14, Arapahoe County, Colorado",1319,29,1288,44,31,37
1400000US08005005619,8005005619,"Census Tract 56.19, Arapahoe County, Colorado",1857,46,1746,83,111,72
1400000US08005005620,8005005620,"Census Tract 56.20, Arapahoe County, Colorado",1800,48,1697,78,103,63
1400000US08005005621,8005005621,"Census Tract 56.21, Arapahoe County, Colorado",1196,41,1151,54,45,41
1400000US08005005622,8005005622,"Census Tract 56.22, Arapahoe County, Colorado",1001,44,962,59,39,42
1400000US08005005623,8005005623,"Census Tract 56.23, Arapahoe County, Colorado",1647,76,1636,77,11,17
1400000US08005005624,8005005624,"Census Tract 56.24, Arapahoe County, Colorado",842,32,837,32,5,8
1400000US08005005625,8005005625,"Census Tract 56.25, Arapahoe County, Colorado",1248,42,1195,57,53,47
1400000US08005005626,8005005626,"Census Tract 56.26, Arapahoe County, Colorado",1647,47,1561,84,86,73
1400000US08005005627,8005005627,"Census Tract 56.27, Arapahoe County, Colorado",1844,51,1796,66,48,49
1400000US08005005628,8005005628,"Census Tract 56.28, Arapahoe County, Colorado",2298,48,2298,48,0,17
1400000US08005005629,8005005629,"Census Tract 56.29, Arapahoe County, Colorado",846,27,822,37,24,30
1400000US08005005630,8005005630,"Census Tract 56.30, Arapahoe County, Colorado",2275,45,2118,117,157,110
1400000US08005005631,8005005631,"Census Tract 56.31, Arapahoe County, Colorado",1254,38,1213,47,41,31
1400000US08005005632,8005005632,"Census Tract 56.32, Arapahoe County, Colorado",1219,27,1177,50,42,45
1400000US08005005633,8005005633,"Census Tract 56.33, Arapahoe County, Colorado",1348,39,1306,48,42,42
1400000US08005005634,8005005634,"Census Tract 56.34, Arapahoe County, Colorado",1648,66,1553,89,95,72
1400000US08005005635,8005005635,"Census Tract 56.35, Arapahoe County, Colorado",2101,39,2017,75,84,67
1400000US08005005636,8005005636,"Census Tract 56.36, Arapahoe County, Colorado",700,35,657,46,43,34
1400000US08005005700,8005005700,"Census Tract 57, Arapahoe County, Colorado",1891,89,1672,149,219,124
1400000US08005005800,8005005800,"Census Tract 58, Arapahoe County, Colorado",1191,80,1143,88,48,49
1400000US08005005951,8005005951,"Census Tract 59.51, Arapahoe County, Colorado",2552,79,2319,151,233,139
1400000US08005005952,8005005952,"Census Tract 59.52, Arapahoe County, Colorado",1519,54,1397,101,122,92
1400000US08005006000,8005006000,"Census Tract 60, Arapahoe County, Colorado",1386,67,1302,79,84,66
1400000US08005006100,8005006100,"Census Tract 61, Arapahoe County, Colorado",1422,44,1354,69,68,54
1400000US08005006200,8005006200,"Census Tract 62, Arapahoe County, Colorado",1287,82,1251,94,36,56
1400000US08005006300,8005006300,"Census Tract 63, Arapahoe County, Colorado",1138,64,1026,76,112,69
1400000US08005006400,8005006400,"Census Tract 64, Arapahoe County, Colorado",1299,56,1247,74,52,56
1400000US08005006501,8005006501,"Census Tract 65.01, Arapahoe County, Colorado",1253,69,1191,93,62,59
1400000US08005006502,8005006502,"Census Tract 65.02, Arapahoe County, Colorado",1576,44,1441,90,135,88
1400000US08005006601,8005006601,"Census Tract 66.01, Arapahoe County, Colorado",2708,87,2396,158,312,152
1400000US08005006603,8005006603,"Census Tract 66.03, Arapahoe County, Colorado",1426,43,1386,73,40,60
1400000US08005006604,8005006604,"Census Tract 66.04, Arapahoe County, Colorado",1971,52,1911,69,60,59
1400000US08005006704,8005006704,"Census Tract 67.04, Arapahoe County, Colorado",1601,83,1466,78,135,76
1400000US08005006705,8005006705,"Census Tract 67.05, Arapahoe County, Colorado",628,41,619,44,9,13
1400000US08005006706,8005006706,"Census Tract 67.06, Arapahoe County, Colorado",2126,39,2052,82,74,74
1400000US08005006707,8005006707,"Census Tract 67.07, Arapahoe County, Colorado",1859,55,1859,55,0,12
1400000US08005006708,8005006708,"Census Tract 67.08, Arapahoe County, Colorado",2023,38,1950,60,73,54
1400000US08005006709,8005006709,"Census Tract 67.09, Arapahoe County, Colorado",2148,61,2072,93,76,71
1400000US08005006711,8005006711,"Census Tract 67.11, Arapahoe County, Colorado",1480,28,1452,49,28,41
1400000US08005006712,8005006712,"Census Tract 67.12, Arapahoe County, Colorado",600,60,486,55,114,53
1400000US08005006713,8005006713,"Census Tract 67.13, Arapahoe County, Colorado",748,35,711,46,37,36
1400000US08005006808,8005006808,"Census Tract 68.08, Arapahoe County, Colorado",1865,41,1799,57,66,41
1400000US08005006815,8005006815,"Census Tract 68.15, Arapahoe County, Colorado",1860,44,1785,79,75,67
1400000US08005006854,8005006854,"Census Tract 68.54, Arapahoe County, Colorado",1108,62,1041,77,67,62
1400000US08005006855,8005006855,"Census Tract 68.55, Arapahoe County, Colorado",1952,40,1919,69,33,51
1400000US08005006856,8005006856,"Census Tract 68.56, Arapahoe County, Colorado",3277,156,3201,188,76,119
1400000US08005006857,8005006857,"Census Tract 68.57, Arapahoe County, Colorado",883,37,883,37,0,12
1400000US08005006858,8005006858,"Census Tract 68.58, Arapahoe County, Colorado",2843,108,2626,140,217,145
1400000US08005007101,8005007101,"Census Tract 71.01, Arapahoe County, Colorado",2050,61,1908,85,142,62
1400000US08005007103,8005007103,"Census Tract 71.03, Arapahoe County, Colorado",558,46,558,46,0,12
1400000US08005007104,8005007104,"Census Tract 71.04, Arapahoe County, Colorado",1623,45,1564,89,59,89
1400000US08005007105,8005007105,"Census Tract 71.05, Arapahoe County, Colorado",1421,146,1313,155,108,91
1400000US08005007106,8005007106,"Census Tract 71.06, Arapahoe County, Colorado",1578,103,1528,129,50,77
1400000US08005007107,8005007107,"Census Tract 71.07, Arapahoe County, Colorado",1830,116,1785,103,45,51
1400000US08005007201,8005007201,"Census Tract 72.01, Arapahoe County, Colorado",1328,40,1208,77,120,63
1400000US08005007202,8005007202,"Census Tract 72.02, Arapahoe County, Colorado",1409,39,1356,62,53,47
1400000US08005007301,8005007301,"Census Tract 73.01, Arapahoe County, Colorado",1027,49,871,84,156,79
1400000US08005007302,8005007302,"Census Tract 73.02, Arapahoe County, Colorado",1805,62,1607,109,198,104
1400000US08005007400,8005007400,"Census Tract 74, Arapahoe County, Colorado",1658,38,1608,60,50,49
1400000US08005007500,8005007500,"Census Tract 75, Arapahoe County, Colorado",811,38,784,49,27,32
1400000US08005007600,8005007600,"Census Tract 76, Arapahoe County, Colorado",1292,26,1254,55,38,43
1400000US08005007702,8005007702,"Census Tract 77.02, Arapahoe County, Colorado",1603,38,1494,79,109,68
1400000US08005007703,8005007703,"Census Tract 77.03, Arapahoe County, Colorado",1674,34,1569,89,105,83
1400000US08005007704,8005007704,"Census Tract 77.04, Arapahoe County, Colorado",1976,55,1850,85,126,77
1400000US08005015100,8005015100,"Census Tract 151, Arapahoe County, Colorado",1039,45,1015,48,24,22
1400000US08005080000,8005080000,"Census Tract 800, Arapahoe County, Colorado",1348,49,1267,77,81,65
1400000US08005080100,8005080100,"Census Tract 801, Arapahoe County, Colorado",1977,67,1805,108,172,95
1400000US08005080200,8005080200,"Census Tract 802, Arapahoe County, Colorado",2006,46,1892,89,114,85
1400000US08005080300,8005080300,"Census Tract 803, Arapahoe County, Colorado",2388,43,2276,113,112,106
1400000US08005080400,8005080400,"Census Tract 804, Arapahoe County, Colorado",2052,37,2005,70,47,56
1400000US08005080500,8005080500,"Census Tract 805, Arapahoe County, Colorado",1719,63,1621,101,98,89
1400000US08005080600,8005080600,"Census Tract 806, Arapahoe County, Colorado",1957,37,1799,102,158,97
1400000US08005080700,8005080700,"Census Tract 807, Arapahoe County, Colorado",2028,38,1784,110,244,107
1400000US08005080800,8005080800,"Census Tract 808, Arapahoe County, Colorado",1171,28,1026,70,145,64
1400000US08005080900,8005080900,"Census Tract 809, Arapahoe County, Colorado",1354,33,1281,68,73,65
1400000US08005081000,8005081000,"Census Tract 810, Arapahoe County, Colorado",2555,66,2391,116,164,99
1400000US08005081100,8005081100,"Census Tract 811, Arapahoe County, Colorado",2665,88,2576,103,89,52
1400000US08005081200,8005081200,"Census Tract 812, Arapahoe County, Colorado",1967,51,1829,89,138,78
1400000US08005081300,8005081300,"Census Tract 813, Arapahoe County, Colorado",1104,25,1011,78,93,74
1400000US08005081400,8005081400,"Census Tract 814, Arapahoe County, Colorado",1718,61,1616,91,102,76
1400000US08005081500,8005081500,"Census Tract 815, Arapahoe County, Colorado",2412,60,2205,131,207,126
1400000US08005081600,8005081600,"Census Tract 816, Arapahoe County, Colorado",1891,35,1780,76,111,66
1400000US08005081700,8005081700,"Census Tract 817, Arapahoe County, Colorado",975,41,966,46,9,13
1400000US08005081800,8005081800,"Census Tract 818, Arapahoe County, Colorado",1657,48,1465,86,192,80
1400000US08005081900,8005081900,"Census Tract 819, Arapahoe County, Colorado",2484,88,2321,172,163,141
1400000US08005082000,8005082000,"Census Tract 820, Arapahoe County, Colorado",1849,42,1689,94,160,79
1400000US08005082100,8005082100,"Census Tract 821, Arapahoe County, Colorado",2470,64,2431,82,39,62
1400000US08005082200,8005082200,"Census Tract 822, Arapahoe County, Colorado",2278,41,2184,110,94,103
1400000US08005082300,8005082300,"Census Tract 823, Arapahoe County, Colorado",1451,33,1425,51,26,38
1400000US08005082400,8005082400,"Census Tract 824, Arapahoe County, Colorado",1579,62,1529,84,50,56
1400000US08005082500,8005082500,"Census Tract 825, Arapahoe County, Colorado",771,17,757,26,14,21
1400000US08005082600,8005082600,"Census Tract 826, Arapahoe County, Colorado",2194,63,2070,124,124,103
1400000US08005082700,8005082700,"Census Tract 827, Arapahoe County, Colorado",1225,26,1142,74,83,73
1400000US08005082800,8005082800,"Census Tract 828, Arapahoe County, Colorado",1942,49,1849,93,93,82
1400000US08005082900,8005082900,"Census Tract 829, Arapahoe County, Colorado",1736,43,1563,115,173,118
1400000US08005083000,8005083000,"Census Tract 830, Arapahoe County, Colorado",1194,31,1194,31,0,12
1400000US08005083100,8005083100,"Census Tract 831, Arapahoe County, Colorado",2578,123,2494,128,84,79
1400000US08005083200,8005083200,"Census Tract 832, Arapahoe County, Colorado",2758,60,2656,102,102,86
1400000US08005083300,8005083300,"Census Tract 833, Arapahoe County, Colorado",1849,56,1802,77,47,51
1400000US08005083400,8005083400,"Census Tract 834, Arapahoe County, Colorado",2240,43,2196,76,44,65
1400000US08005083500,8005083500,"Census Tract 835, Arapahoe County, Colorado",2221,44,2106,76,115,57
1400000US08005083600,8005083600,"Census Tract 836, Arapahoe County, Colorado",1758,41,1696,74,62,67
1400000US08005083700,8005083700,"Census Tract 837, Arapahoe County, Colorado",1751,48,1610,112,141,105
1400000US08005083800,8005083800,"Census Tract 838, Arapahoe County, Colorado",1210,24,1170,57,40,58
1400000US08005083900,8005083900,"Census Tract 839, Arapahoe County, Colorado",1655,27,1555,93,100,91
1400000US08005084000,8005084000,"Census Tract 840, Arapahoe County, Colorado",779,27,753,41,26,31
1400000US08005084100,8005084100,"Census Tract 841, Arapahoe County, Colorado",1653,31,1532,85,121,79
1400000US08005084200,8005084200,"Census Tract 842, Arapahoe County, Colorado",1371,25,1324,46,47,37
1400000US08005084300,8005084300,"Census Tract 843, Arapahoe County, Colorado",1206,23,1169,46,37,36
1400000US08005084400,8005084400,"Census Tract 844, Arapahoe County, Colorado",1070,26,1030,48,40,40
1400000US08005084500,8005084500,"Census Tract 845, Arapahoe County, Colorado",1288,31,1152,86,136,83
1400000US08005084600,8005084600,"Census Tract 846, Arapahoe County, Colorado",2027,36,1984,59,43,47
1400000US08005084700,8005084700,"Census Tract 847, Arapahoe County, Colorado",1727,27,1710,37,17,28
1400000US08005084800,8005084800,"Census Tract 848, Arapahoe County, Colorado",1249,30,1249,30,0,12
1400000US08005084900,8005084900,"Census Tract 849, Arapahoe County, Colorado",1023,51,977,55,46,48
1400000US08005085000,8005085000,"Census Tract 850, Arapahoe County, Colorado",626,20,580,44,46,40
1400000US08005085100,8005085100,"Census Tract 851, Arapahoe County, Colorado",1997,54,1997,54,0,17
1400000US08005085200,8005085200,"Census Tract 852, Arapahoe County, Colorado",1004,18,1004,18,0,12
1400000US08005085300,8005085300,"Census Tract 853, Arapahoe County, Colorado",998,33,998,33,0,12
1400000US08005085400,8005085400,"Census Tract 854, Arapahoe County, Colorado",1452,40,1414,52,38,41
1400000US08005085500,8005085500,"Census Tract 855, Arapahoe County, Colorado",1791,35,1764,58,27,42
1400000US08005085600,8005085600,"Census Tract 856, Arapahoe County, Colorado",1032,32,1032,32,0,12
1400000US08005085700,8005085700,"Census Tract 857, Arapahoe County, Colorado",1857,50,1764,89,93,77
1400000US08005085800,8005085800,"Census Tract 858, Arapahoe County, Colorado",642,14,642,14,0,12
1400000US08005085900,8005085900,"Census Tract 859, Arapahoe County, Colorado",1073,64,1066,63,7,13
1400000US08005086000,8005086000,"Census Tract 860, Arapahoe County, Colorado",2429,112,2319,127,110,109
1400000US08005086100,8005086100,"Census Tract 861, Arapahoe County, Colorado",1509,78,1443,96,66,77
1400000US08005086200,8005086200,"Census Tract 862, Arapahoe County, Colorado",1954,43,1899,69,55,56
1400000US08005086300,8005086300,"Census Tract 863, Arapahoe County, Colorado",1857,54,1787,81,70,60
1400000US08005086400,8005086400,"Census Tract 864, Arapahoe County, Colorado",758,21,758,21,0,12
1400000US08005086500,8005086500,"Census Tract 865, Arapahoe County, Colorado",2098,91,1919,133,179,116
1400000US08005086600,8005086600,"Census Tract 866, Arapahoe County, Colorado",2388,101,2163,136,225,151
1400000US08005086700,8005086700,"Census Tract 867, Arapahoe County, Colorado",1230,70,1205,80,25,40
1400000US08005086800,8005086800,"Census Tract 868, Arapahoe County, Colorado",3066,79,2796,146,270,139
1400000US08005086900,8005086900,"Census Tract 869, Arapahoe County, Colorado",1485,63,1425,76,60,53
1400000US08005087000,8005087000,"Census Tract 870, Arapahoe County, Colorado",2298,49,2167,104,131,95
1400000US08005087100,8005087100,"Census Tract 871, Arapahoe County, Colorado",1430,31,1312,71,118,75
1400000US08005087200,8005087200,"Census Tract 872, Arapahoe County, Colorado",2242,62,1994,162,248,161
1400000US08005087300,8005087300,"Census Tract 873, Arapahoe County, Colorado",3359,148,3156,194,203,145
1400000US08031000102,8031000102,"Census Tract 1.02, Denver County, Colorado",1662,28,1534,86,128,77
1400000US08031000201,8031000201,"Census Tract 2.01, Denver County, Colorado",1551,55,1505,82,46,61
1400000US08031000202,8031000202,"Census Tract 2.02, Denver County, Colorado",1681,57,1603,90,78,70
1400000US08031000301,8031000301,"Census Tract 3.01, Denver County, Colorado",2732,98,2605,126,127,98
1400000US08031000302,8031000302,"Census Tract 3.02, Denver County, Colorado",1993,129,1959,129,34,40
1400000US08031000303,8031000303,"Census Tract 3.03, Denver County, Colorado",2395,80,2215,143,180,134
1400000US08031000401,8031000401,"Census Tract 4.01, Denver County, Colorado",1486,60,1478,62,8,13
1400000US08031000402,8031000402,"Census Tract 4.02, Denver County, Colorado",3064,125,2877,156,187,115
1400000US08031000501,8031000501,"Census Tract 5.01, Denver County, Colorado",1004,24,974,43,30,33
1400000US08031000502,8031000502,"Census Tract 5.02, Denver County, Colorado",2789,107,2750,124,39,62
1400000US08031000600,8031000600,"Census Tract 6, Denver County, Colorado",1397,59,1253,89,144,70
1400000US08031000701,8031000701,"Census Tract 7.01, Denver County, Colorado",1942,55,1758,99,184,84
1400000US08031000702,8031000702,"Census Tract 7.02, Denver County, Colorado",2116,81,2015,103,101,73
1400000US08031000800,8031000800,"Census Tract 8, Denver County, Colorado",501,30,501,30,0,12
1400000US08031000902,8031000902,"Census Tract 9.02, Denver County, Colorado",1813,57,1674,96,139,83
1400000US08031000903,8031000903,"Census Tract 9.03, Denver County, Colorado",1981,37,1909,82,72,67
1400000US08031000904,8031000904,"Census Tract 9.04, Denver County, Colorado",1908,62,1797,82,111,63
1400000US08031000905,8031000905,"Census Tract 9.05, Denver County, Colorado",1244,35,1160,61,84,54
1400000US08031001000,8031001000,"Census Tract 10, Denver County, Colorado",1271,59,1165,92,106,64
1400000US08031001101,8031001101,"Census Tract 11.01, Denver County, Colorado",1025,37,969,51,56,41
1400000US08031001102,8031001102,"Census Tract 11.02, Denver County, Colorado",1673,60,1529,85,144,65
1400000US08031001301,8031001301,"Census Tract 13.01, Denver County, Colorado",1651,40,1526,103,125,90
1400000US08031001302,8031001302,"Census Tract 13.02, Denver County, Colorado",1362,37,1362,37,0,12
1400000US08031001401,8031001401,"Census Tract 14.01, Denver County, Colorado",2131,56,1977,85,154,67
1400000US08031001402,8031001402,"Census Tract 14.02, Denver County, Colorado",1460,28,1400,74,60,67
1400000US08031001403,8031001403,"Census Tract 14.03, Denver County, Colorado",1694,49,1529,120,165,110
1400000US08031001500,8031001500,"Census Tract 15, Denver County, Colorado",1174,50,1042,85,132,74
1400000US08031001600,8031001600,"Census Tract 16, Denver County, Colorado",4541,136,4064,281,477,272
1400000US08031001701,8031001701,"Census Tract 17.01, Denver County, Colorado",3837,68,3190,188,647,199
1400000US08031001702,8031001702,"Census Tract 17.02, Denver County, Colorado",3261,116,2298,262,963,259
1400000US08031001800,8031001800,"Census Tract 18, Denver County, Colorado",1850,48,1627,105,223,96
1400000US08031001901,8031001901,"Census Tract 19.01, Denver County, Colorado",1060,72,930,100,130,84
1400000US08031001902,8031001902,"Census Tract 19.02, Denver County, Colorado",52,23,49,25,3,6
1400000US08031002000,8031002000,"Census Tract 20, Denver County, Colorado",1407,35,1325,80,82,66
1400000US08031002100,8031002100,"Census Tract 21, Denver County, Colorado",2750,71,2571,132,179,121
1400000US08031002300,8031002300,"Census Tract 23, Denver County, Colorado",2195,45,2142,67,53,49
1400000US08031002402,8031002402,"Census Tract 24.02, Denver County, Colorado",863,52,822,68,41,46
1400000US08031002403,8031002403,"Census Tract 24.03, Denver County, Colorado",2216,89,1991,127,225,113
1400000US08031002601,8031002601,"Census Tract 26.01, Denver County, Colorado",2419,84,2195,134,224,100
1400000US08031002602,8031002602,"Census Tract 26.02, Denver County, Colorado",1745,56,1686,92,59,79
1400000US08031002701,8031002701,"Census Tract 27.01, Denver County, Colorado",3740,89,3442,148,298,135
1400000US08031002702,8031002702,"Census Tract 27.02, Denver County, Colorado",4044,83,3758,166,286,164
1400000US08031002703,8031002703,"Census Tract 27.03, Denver County, Colorado",3707,96,3358,194,349,187
1400000US08031002801,8031002801,"Census Tract 28.01, Denver County, Colorado",1706,61,1595,86,111,65
1400000US08031002802,8031002802,"Census Tract 28.02, Denver County, Colorado",2958,58,2805,114,153,105
1400000US08031002803,8031002803,"Census Tract 28.03, Denver County, Colorado",3315,53,3079,137,236,139
1400000US08031002901,8031002901,"Census Tract 29.01, Denver County, Colorado",1508,54,1487,59,21,34
1400000US08031002902,8031002902,"Census Tract 29.02, Denver County, Colorado",2057,54,1974,80,83,69
1400000US08031003001,8031003001,"Census Tract 30.01, Denver County, Colorado",2908,92,2716,148,192,137
1400000US08031003002,8031003002,"Census Tract 30.02, Denver County, Colorado",1383,46,1266,91,117,87
1400000US08031003003,8031003003,"Census Tract 30.03, Denver County, Colorado",1194,30,1073,88,121,82
1400000US08031003004,8031003004,"Census Tract 30.04, Denver County, Colorado",2616,98,2533,149,83,115
1400000US08031003101,8031003101,"Census Tract 31.01, Denver County, Colorado",826,26,732,62,94,59
1400000US08031003102,8031003102,"Census Tract 31.02, Denver County, Colorado",1928,66,1738,91,190,100
1400000US08031003201,8031003201,"Census Tract 32.01, Denver County, Colorado",3614,119,3225,217,389,197
1400000US08031003202,8031003202,"Census Tract 32.02, Denver County, Colorado",2151,33,1896,140,255,135
1400000US08031003203,8031003203,"Census Tract 32.03, Denver County, Colorado",1392,27,1342,58,50,52
1400000US08031003300,8031003300,"Census Tract 33, Denver County, Colorado",1483,49,1483,49,0,12
1400000US08031003401,8031003401,"Census Tract 34.01, Denver County, Colorado",1421,61,1221,92,200,90
1400000US08031003402,8031003402,"Census Tract 34.02, Denver County, Colorado",2093,46,2034,79,59,57
1400000US08031003500,8031003500,"Census Tract 35, Denver County, Colorado",1894,52,1763,81,131,66
1400000US08031003601,8031003601,"Census Tract 36.01, Denver County, Colorado",1806,52,1676,80,130,67
1400000US08031003602,8031003602,"Census Tract 36.02, Denver County, Colorado",1639,44,1488,97,151,85
1400000US08031003603,8031003603,"Census Tract 36.03, Denver County, Colorado",1469,66,1355,91,114,82
1400000US08031003701,8031003701,"Census Tract 37.01, Denver County, Colorado",1763,82,1542,119,221,109
1400000US08031003702,8031003702,"Census Tract 37.02, Denver County, Colorado",2808,88,2740,100,68,53
1400000US08031003703,8031003703,"Census Tract 37.03, Denver County, Colorado",1716,61,1546,99,170,93
1400000US08031003800,8031003800,"Census Tract 38, Denver County, Colorado",4301,110,3942,165,359,155
1400000US08031003901,8031003901,"Census Tract 39.01, Denver County, Colorado",2426,115,2277,141,149,82
1400000US08031003902,8031003902,"Census Tract 39.02, Denver County, Colorado",1872,35,1827,61,45,49
1400000US08031004002,8031004002,"Census Tract 40.02, Denver County, Colorado",1415,42,1386,51,29,27
1400000US08031004003,8031004003,"Census Tract 40.03, Denver County, Colorado",1985,49,1893,68,92,59
1400000US08031004004,8031004004,"Census Tract 40.04, Denver County, Colorado",879,20,828,43,51,39
1400000US08031004005,8031004005,"Census Tract 40.05, Denver County, Colorado",1778,64,1601,107,177,83
1400000US08031004006,8031004006,"Census Tract 40.06, Denver County, Colorado",2200,76,2049,99,151,84
1400000US08031004101,8031004101,"Census Tract 41.01, Denver County, Colorado",1663,51,1598,76,65,54
1400000US08031004102,8031004102,"Census Tract 41.02, Denver County, Colorado",1551,65,1353,108,198,90
1400000US08031004103,8031004103,"Census Tract 41.03, Denver County, Colorado",2208,47,2139,78,69,65
1400000US08031004104,8031004104,"Census Tract 41.04, Denver County, Colorado",1919,51,1862,82,57,62
1400000US08031004106,8031004106,"Census Tract 41.06, Denver County, Colorado",3094,87,2992,117,102,83
1400000US08031004107,8031004107,"Census Tract 41.07, Denver County, Colorado",2334,110,2204,126,130,95
1400000US08031004201,8031004201,"Census Tract 42.01, Denver County, Colorado",2033,31,1975,76,58,68
1400000US08031004202,8031004202,"Census Tract 42.02, Denver County, Colorado",1691,39,1617,83,74,71
1400000US08031004301,8031004301,"Census Tract 43.01, Denver County, Colorado",3087,52,2797,162,290,156
1400000US08031004302,8031004302,"Census Tract 43.02, Denver County, Colorado",1253,60,1217,70,36,41
1400000US08031004303,8031004303,"Census Tract 43.03, Denver County, Colorado",1684,43,1582,84,102,68
1400000US08031004304,8031004304,"Census Tract 43.04, Denver County, Colorado",2869,56,2809,88,60,73
1400000US08031004306,8031004306,"Census Tract 43.06, Denver County, Colorado",2285,55,2285,55,0,12
1400000US08031004403,8031004403,"Census Tract 44.03, Denver County, Colorado",1937,62,1646,127,291,109
1400000US08031004404,8031004404,"Census Tract 44.04, Denver County, Colorado",2617,63,2427,115,190,96
1400000US08031004405,8031004405,"Census Tract 44.05, Denver County, Colorado",4233,74,3854,170,379,149
1400000US08031004503,8031004503,"Census Tract 45.03, Denver County, Colorado",1306,54,1254,76,52,53
1400000US08031004504,8031004504,"Census Tract 45.04, Denver County, Colorado",1154,46,1084,64,70,46
1400000US08031004505,8031004505,"Census Tract 45.05, Denver County, Colorado",1324,33,1255,66,69,55
1400000US08031004506,8031004506,"Census Tract 45.06, Denver County, Colorado",1047,42,975,76,72,67
1400000US08031004601,8031004601,"Census Tract 46.01, Denver County, Colorado",1932,32,1868,57,64,51
1400000US08031004602,8031004602,"Census Tract 46.02, Denver County, Colorado",2362,48,2229,119,133,93
1400000US08031004603,8031004603,"Census Tract 46.03, Denver County, Colorado",2049,39,1991,58,58,51
1400000US08031004700,8031004700,"Census Tract 47, Denver County, Colorado",2243,83,2168,113,75,87
1400000US08031004801,8031004801,"Census Tract 48.01, Denver County, Colorado",1092,21,1060,39,32,38
1400000US08031005001,8031005001,"Census Tract 50.01, Denver County, Colorado",1129,24,1101,46,28,40
1400000US08031005002,8031005002,"Census Tract 50.02, Denver County, Colorado",3548,108,3363,152,185,118
1400000US08031005102,8031005102,"Census Tract 51.02, Denver County, Colorado",1611,34,1513,84,98,76
1400000US08031005104,8031005104,"Census Tract 51.04, Denver County, Colorado",1668,39,1481,98,187,95
1400000US08031005200,8031005200,"Census Tract 52, Denver County, Colorado",1427,27,1353,73,74,66
1400000US08031005300,8031005300,"Census Tract 53, Denver County, Colorado",686,38,646,47,40,36
1400000US08031005502,8031005502,"Census Tract 55.02, Denver County, Colorado",600,27,554,47,46,37
1400000US08031005503,8031005503,"Census Tract 55.03, Denver County, Colorado",1813,65,1792,68,21,24
1400000US08031006701,8031006701,"Census Tract 67.01, Denver County, Colorado",2019,39,1728,104,291,107
1400000US08031006804,8031006804,"Census Tract 68.04, Denver County, Colorado",1397,33,1255,87,142,83
1400000US08031006809,8031006809,"Census Tract 68.09, Denver County, Colorado",3729,98,3530,162,199,141
1400000US08031006810,8031006810,"Census Tract 68.10, Denver County, Colorado",2693,62,2554,129,139,122
1400000US08031006811,8031006811,"Census Tract 68.11, Denver County, Colorado",3365,67,3135,143,230,128
1400000US08031006812,8031006812,"Census Tract 68.12, Denver County, Colorado",1864,30,1728,97,136,93
1400000US08031006813,8031006813,"Census Tract 68.13, Denver County, Colorado",2600,51,2370,160,230,154
1400000US08031006814,8031006814,"Census Tract 68.14, Denver County, Colorado",2135,80,2009,125,126,115
1400000US08031006901,8031006901,"Census Tract 69.01, Denver County, Colorado",2844,126,2626,152,218,101
1400000US08031007006,8031007006,"Census Tract 70.06, Denver County, Colorado",2639,76,2324,154,315,129
1400000US08031007013,8031007013,"Census Tract 70.13, Denver County, Colorado",2002,33,1851,108,151,99
1400000US08031007037,8031007037,"Census Tract 70.37, Denver County, Colorado",1910,46,1695,109,215,105
1400000US08031007088,8031007088,"Census Tract 70.88, Denver County, Colorado",2649,60,2422,130,227,118
1400000US08031007089,8031007089,"Census Tract 70.89, Denver County, Colorado",3832,73,3366,167,466,159
1400000US08031008304,8031008304,"Census Tract 83.04, Denver County, Colorado",923,36,884,46,39,37
1400000US08031008305,8031008305,"Census Tract 83.05, Denver County, Colorado",1020,35,981,58,39,48
1400000US08031008306,8031008306,"Census Tract 83.06, Denver County, Colorado",1831,50,1698,87,133,64
1400000US08031008312,8031008312,"Census Tract 83.12, Denver County, Colorado",2119,60,2088,73,31,41
1400000US08031008386,8031008386,"Census Tract 83.86, Denver County, Colorado",1167,38,1099,72,68,60
1400000US08031008387,8031008387,"Census Tract 83.87, Denver County, Colorado",1606,42,1586,51,20,32
1400000US08031008388,8031008388,"Census Tract 83.88, Denver County, Colorado",2786,80,2662,140,124,116
1400000US08031008389,8031008389,"Census Tract 83.89, Denver County, Colorado",2546,109,2505,123,41,64
1400000US08031008390,8031008390,"Census Tract 83.90, Denver County, Colorado",2771,94,2740,103,31,48
1400000US08031008391,8031008391,"Census Tract 83.91, Denver County, Colorado",2380,75,2357,81,23,40
1400000US08031011902,8031011902,"Census Tract 119.02, Denver County, Colorado",2928,55,2812,120,116,101
1400000US08031011903,8031011903,"Census Tract 119.03, Denver County, Colorado",941,21,941,21,0,12
1400000US08031012001,8031012001,"Census Tract 120.01, Denver County, Colorado",1029,43,959,58,70,44
1400000US08031012010,8031012010,"Census Tract 120.10, Denver County, Colorado",2492,73,2359,112,133,126
1400000US08031012014,8031012014,"Census Tract 120.14, Denver County, Colorado",3023,63,2860,148,163,136
1400000US08031015300,8031015300,"Census Tract 153, Denver County, Colorado",2435,54,2144,168,291,176
1400000US08031015400,8031015400,"Census Tract 154, Denver County, Colorado",1694,63,1681,64,13,16
1400000US08031015500,8031015500,"Census Tract 155, Denver County, Colorado",1850,48,1744,73,106,61
1400000US08031015600,8031015600,"Census Tract 156, Denver County, Colorado",2252,94,2124,118,128,79
1400000US08031015700,8031015700,"Census Tract 157, Denver County, Colorado",2210,58,2064,118,146,113
1400000US08031980000,8031980000,"Census Tract 9800, Denver County, Colorado",603,43,503,78,100,67
1400000US08031980100,8031980100,"Census Tract 9801, Denver County, Colorado",0,12,0,12,0,12
1400000US08035013901,8035013901,"Census Tract 139.01, Douglas County, Colorado",2858,59,2679,104,179,105
1400000US08035013904,8035013904,"Census Tract 139.04, Douglas County, Colorado",1824,54,1715,97,109,76
1400000US08035013905,8035013905,"Census Tract 139.05, Douglas County, Colorado",1436,48,1345,88,91,75
1400000US08035013907,8035013907,"Census Tract 139.07, Douglas County, Colorado",1887,61,1859,74,28,44
1400000US08035013908,8035013908,"Census Tract 139.08, Douglas County, Colorado",2371,100,2364,101,7,13
1400000US08035013909,8035013909,"Census Tract 139.09, Douglas County, Colorado",2191,73,2191,73,0,17
1400000US08035013910,8035013910,"Census Tract 139.10, Douglas County, Colorado",2061,62,2061,62,0,17
1400000US08035013911,8035013911,"Census Tract 139.11, Douglas County, Colorado",2120,65,2057,98,63,72
1400000US08035014001,8035014001,"Census Tract 140.01, Douglas County, Colorado",2755,71,2541,161,214,153
1400000US08035014005,8035014005,"Census Tract 140.05, Douglas County, Colorado",1756,37,1704,63,52,57
1400000US08035014006,8035014006,"Census Tract 140.06, Douglas County, Colorado",1990,115,1976,113,14,23
1400000US08035014007,8035014007,"Census Tract 140.07, Douglas County, Colorado",1342,51,1186,118,156,105
1400000US08035014008,8035014008,"Census Tract 140.08, Douglas County, Colorado",2263,39,2107,142,156,133
1400000US08035014009,8035014009,"Census Tract 140.09, Douglas County, Colorado",1177,64,1148,67,29,32
1400000US08035014010,8035014010,"Census Tract 140.10, Douglas County, Colorado",2105,85,2015,116,90,72
1400000US08035014011,8035014011,"Census Tract 140.11, Douglas County, Colorado",996,110,933,99,63,55
1400000US08035014012,8035014012,"Census Tract 140.12, Douglas County, Colorado",2773,114,2669,126,104,96
1400000US08035014013,8035014013,"Census Tract 140.13, Douglas County, Colorado",1281,67,1281,67,0,12
1400000US08035014107,8035014107,"Census Tract 141.07, Douglas County, Colorado",1377,33,1303,82,74,77
1400000US08035014108,8035014108,"Census Tract 141.08, Douglas County, Colorado",1831,28,1796,55,35,55
1400000US08035014109,8035014109,"Census Tract 141.09, Douglas County, Colorado",1205,48,1022,83,183,74
1400000US08035014110,8035014110,"Census Tract 141.10, Douglas County, Colorado",2329,45,2209,109,120,99
1400000US08035014112,8035014112,"Census Tract 141.12, Douglas County, Colorado",1443,54,1443,54,0,12
1400000US08035014113,8035014113,"Census Tract 141.13, Douglas County, Colorado",1009,24,993,36,16,25
1400000US08035014114,8035014114,"Census Tract 141.14, Douglas County, Colorado",1392,43,1392,43,0,12
1400000US08035014115,8035014115,"Census Tract 141.15, Douglas County, Colorado",1762,110,1694,121,68,74
1400000US08035014116,8035014116,"Census Tract 141.16, Douglas County, Colorado",2189,135,2140,148,49,69
1400000US08035014122,8035014122,"Census Tract 141.22, Douglas County, Colorado",2616,115,2424,132,192,133
1400000US08035014123,8035014123,"Census Tract 141.23, Douglas County, Colorado",1304,47,1145,102,159,89
1400000US08035014124,8035014124,"Census Tract 141.24, Douglas County, Colorado",1774,39,1687,95,87,95
1400000US08035014125,8035014125,"Census Tract 141.25, Douglas County, Colorado",1151,97,1038,105,113,96
1400000US08035014126,8035014126,"Census Tract 141.26, Douglas County, Colorado",880,68,825,79,55,51
1400000US08035014127,8035014127,"Census Tract 141.27, Douglas County, Colorado",1826,112,1826,112,0,17
1400000US08035014128,8035014128,"Census Tract 141.28, Douglas County, Colorado",1828,48,1818,50,10,16
1400000US08035014129,8035014129,"Census Tract 141.29, Douglas County, Colorado",1231,32,1205,46,26,38
1400000US08035014130,8035014130,"Census Tract 141.30, Douglas County, Colorado",2449,41,2449,41,0,17
1400000US08035014131,8035014131,"Census Tract 141.31, Douglas County, Colorado",1818,73,1740,85,78,46
1400000US08035014132,8035014132,"Census Tract 141.32, Douglas County, Colorado",1801,42,1789,46,12,21
1400000US08035014133,8035014133,"Census Tract 141.33, Douglas County, Colorado",2183,65,2148,96,35,54
1400000US08035014134,8035014134,"Census Tract 141.34, Douglas County, Colorado",1971,38,1932,59,39,39
1400000US08035014135,8035014135,"Census Tract 141.35, Douglas County, Colorado",956,80,887,83,69,56
1400000US08035014136,8035014136,"Census Tract 141.36, Douglas County, Colorado",3010,67,2853,109,157,91
1400000US08035014137,8035014137,"Census Tract 141.37, Douglas County, Colorado",2927,89,2913,89,14,24
1400000US08035014138,8035014138,"Census Tract 141.38, Douglas County, Colorado",1808,58,1718,95,90,75
1400000US08035014139,8035014139,"Census Tract 141.39, Douglas County, Colorado",1614,54,1535,97,79,76
1400000US08035014140,8035014140,"Census Tract 141.40, Douglas County, Colorado",1828,49,1828,49,0,17
1400000US08035014202,8035014202,"Census Tract 142.02, Douglas County, Colorado",703,46,661,56,42,40
1400000US08035014203,8035014203,"Census Tract 142.03, Douglas County, Colorado",2289,106,2225,117,64,70
1400000US08035014204,8035014204,"Census Tract 142.04, Douglas County, Colorado",1122,42,993,98,129,90
1400000US08035014300,8035014300,"Census Tract 143, Douglas County, Colorado",482,50,323,51,159,49
1400000US08035014403,8035014403,"Census Tract 144.03, Douglas County, Colorado",1990,106,1922,129,68,66
1400000US08035014404,8035014404,"Census Tract 144.04, Douglas County, Colorado",1100,28,988,67,112,63
1400000US08035014405,8035014405,"Census Tract 144.05, Douglas County, Colorado",2516,86,2516,86,0,17
1400000US08035014406,8035014406,"Census Tract 144.06, Douglas County, Colorado",3006,114,2933,109,73,89
1400000US08035014503,8035014503,"Census Tract 145.03, Douglas County, Colorado",2189,77,2077,114,112,99
1400000US08035014504,8035014504,"Census Tract 145.04, Douglas County, Colorado",1934,48,1750,103,184,93
1400000US08035014505,8035014505,"Census Tract 145.05, Douglas County, Colorado",1935,74,1773,99,162,90
1400000US08035014506,8035014506,"Census Tract 145.06, Douglas County, Colorado",1294,93,1214,99,80,81
1400000US08035014602,8035014602,"Census Tract 146.02, Douglas County, Colorado",939,31,864,48,75,44
1400000US08035014603,8035014603,"Census Tract 146.03, Douglas County, Colorado",2274,70,2274,70,0,17
1400000US08035014604,8035014604,"Census Tract 146.04, Douglas County, Colorado",1364,46,1308,87,56,82
1400000US08059009806,8059009806,"Census Tract 98.06, Jefferson County, Colorado",1481,52,1450,64,31,42
1400000US08059009807,8059009807,"Census Tract 98.07, Jefferson County, Colorado",825,18,767,61,58,57
1400000US08059009808,8059009808,"Census Tract 98.08, Jefferson County, Colorado",2799,79,2410,173,389,148
1400000US08059009815,8059009815,"Census Tract 98.15, Jefferson County, Colorado",1931,36,1872,67,59,60
1400000US08059009823,8059009823,"Census Tract 98.23, Jefferson County, Colorado",1778,52,1694,92,84,87
1400000US08059009824,8059009824,"Census Tract 98.24, Jefferson County, Colorado",1867,52,1816,70,51,54
1400000US08059009827,8059009827,"Census Tract 98.27, Jefferson County, Colorado",2433,92,2263,138,170,113
1400000US08059009828,8059009828,"Census Tract 98.28, Jefferson County, Colorado",2146,83,2056,118,90,102
1400000US08059009829,8059009829,"Census Tract 98.29, Jefferson County, Colorado",664,24,664,24,0,12
1400000US08059009830,8059009830,"Census Tract 98.30, Jefferson County, Colorado",1011,39,972,62,39,49
1400000US08059009831,8059009831,"Census Tract 98.31, Jefferson County, Colorado",1316,57,1226,80,90,72
1400000US08059009832,8059009832,"Census Tract 98.32, Jefferson County, Colorado",977,23,927,38,50,32
1400000US08059009833,8059009833,"Census Tract 98.33, Jefferson County, Colorado",2460,61,2460,61,0,17
1400000US08059009834,8059009834,"Census Tract 98.34, Jefferson County, Colorado",2077,48,1969,83,108,71
1400000US08059009835,8059009835,"Census Tract 98.35, Jefferson County, Colorado",1439,25,1439,25,0,12
1400000US08059009836,8059009836,"Census Tract 98.36, Jefferson County, Colorado",1395,24,1395,24,0,12
1400000US08059009837,8059009837,"Census Tract 98.37, Jefferson County, Colorado",948,37,922,40,26,25
1400000US08059009838,8059009838,"Census Tract 98.38, Jefferson County, Colorado",1632,32,1597,46,35,35
1400000US08059009839,8059009839,"Census Tract 98.39, Jefferson County, Colorado",845,17,818,31,27,27
1400000US08059009840,8059009840,"Census Tract 98.40, Jefferson County, Colorado",1542,53,1511,62,31,31
1400000US08059009841,8059009841,"Census Tract 98.41, Jefferson County, Colorado",868,20,868,20,0,12
1400000US08059009842,8059009842,"Census Tract 98.42, Jefferson County, Colorado",1154,55,1059,97,95,84
1400000US08059009843,8059009843,"Census Tract 98.43, Jefferson County, Colorado",3172,93,3080,133,92,95
1400000US08059009845,8059009845,"Census Tract 98.45, Jefferson County, Colorado",1873,29,1722,80,151,74
1400000US08059009846,8059009846,"Census Tract 98.46, Jefferson County, Colorado",2037,42,1861,114,176,106
1400000US08059009847,8059009847,"Census Tract 98.47, Jefferson County, Colorado",1391,36,1271,81,120,77
1400000US08059009848,8059009848,"Census Tract 98.48, Jefferson County, Colorado",1115,39,943,83,172,88
1400000US08059009849,8059009849,"Census Tract 98.49, Jefferson County, Colorado",2461,146,2461,146,0,17
1400000US08059009850,8059009850,"Census Tract 98.50, Jefferson County, Colorado",1104,62,996,80,108,71
1400000US08059009851,8059009851,"Census Tract 98.51, Jefferson County, Colorado",1598,28,1519,73,79,68
1400000US08059009852,8059009852,"Census Tract 98.52, Jefferson County, Colorado",1440,64,1440,64,0,12
1400000US08059009900,8059009900,"Census Tract 99, Jefferson County, Colorado",1180,77,1130,84,50,36
1400000US08059010000,8059010000,"Census Tract 100, Jefferson County, Colorado",1375,94,1263,102,112,57
1400000US08059010100,8059010100,"Census Tract 101, Jefferson County, Colorado",2208,50,2125,89,83,74
1400000US08059010205,8059010205,"Census Tract 102.05, Jefferson County, Colorado",990,30,967,38,23,25
1400000US08059010206,8059010206,"Census Tract 102.06, Jefferson County, Colorado",1688,34,1660,55,28,45
1400000US08059010208,8059010208,"Census Tract 102.08, Jefferson County, Colorado",2133,74,2133,74,0,17
1400000US08059010209,8059010209,"Census Tract 102.09, Jefferson County, Colorado",2604,57,2465,121,139,121
1400000US08059010210,8059010210,"Census Tract 102.10, Jefferson County, Colorado",1449,41,1358,62,91,54
1400000US08059010211,8059010211,"Census Tract 102.11, Jefferson County, Colorado",1505,32,1490,38,15,19
1400000US08059010212,8059010212,"Census Tract 102.12, Jefferson County, Colorado",1844,40,1783,60,61,51
1400000US08059010213,8059010213,"Census Tract 102.13, Jefferson County, Colorado",1936,46,1800,108,136,92
1400000US08059010303,8059010303,"Census Tract 103.03, Jefferson County, Colorado",2263,48,2226,76,37,59
1400000US08059010304,8059010304,"Census Tract 103.04, Jefferson County, Colorado",1169,26,1076,53,93,53
1400000US08059010305,8059010305,"Census Tract 103.05, Jefferson County, Colorado",1676,40,1607,80,69,65
1400000US08059010306,8059010306,"Census Tract 103.06, Jefferson County, Colorado",1132,23,1132,23,0,12
1400000US08059010307,8059010307,"Census Tract 103.07, Jefferson County, Colorado",2116,47,2094,59,22,36
1400000US08059010308,8059010308,"Census Tract 103.08, Jefferson County, Colorado",2431,46,2354,65,77,55
1400000US08059010402,8059010402,"Census Tract 104.02, Jefferson County, Colorado",2697,44,2603,101,94,88
1400000US08059010403,8059010403,"Census Tract 104.03, Jefferson County, Colorado",2616,84,2349,143,267,146
1400000US08059010405,8059010405,"Census Tract 104.05, Jefferson County, Colorado",1444,61,1377,67,67,59
1400000US08059010406,8059010406,"Census Tract 104.06, Jefferson County, Colorado",1015,40,991,47,24,27
1400000US08059010502,8059010502,"Census Tract 105.02, Jefferson County, Colorado",2376,76,2230,124,146,98
1400000US08059010503,8059010503,"Census Tract 105.03, Jefferson County, Colorado",2086,74,1949,115,137,92
1400000US08059010504,8059010504,"Census Tract 105.04, Jefferson County, Colorado",1258,54,1188,74,70,65
1400000US08059010603,8059010603,"Census Tract 106.03, Jefferson County, Colorado",1763,55,1717,71,46,47
1400000US08059010604,8059010604,"Census Tract 106.04, Jefferson County, Colorado",1128,44,1040,83,88,75
1400000US08059010701,8059010701,"Census Tract 107.01, Jefferson County, Colorado",2129,82,2086,97,43,66
1400000US08059010702,8059010702,"Census Tract 107.02, Jefferson County, Colorado",2397,103,2206,152,191,125
1400000US08059010801,8059010801,"Census Tract 108.01, Jefferson County, Colorado",1106,37,1066,51,40,38
1400000US08059010901,8059010901,"Census Tract 109.01, Jefferson County, Colorado",2104,46,1968,120,136,114
1400000US08059010902,8059010902,"Census Tract 109.02, Jefferson County, Colorado",1202,27,1091,77,111,74
1400000US08059011000,8059011000,"Census Tract 110, Jefferson County, Colorado",2348,82,2253,130,95,107
1400000US08059011100,8059011100,"Census Tract 111, Jefferson County, Colorado",2818,69,2773,87,45,50
1400000US08059011202,8059011202,"Census Tract 112.02, Jefferson County, Colorado",1733,57,1625,91,108,82
1400000US08059011300,8059011300,"Census Tract 113, Jefferson County, Colorado",1464,169,1386,156,78,69
1400000US08059011401,8059011401,"Census Tract 114.01, Jefferson County, Colorado",1118,104,1084,97,34,42
1400000US08059011402,8059011402,"Census Tract 114.02, Jefferson County, Colorado",2022,57,1909,96,113,83
1400000US08059011550,8059011550,"Census Tract 115.50, Jefferson County, Colorado",2834,121,2626,171,208,124
1400000US08059011601,8059011601,"Census Tract 116.01, Jefferson County, Colorado",1458,61,1383,88,75,67
1400000US08059011602,8059011602,"Census Tract 116.02, Jefferson County, Colorado",1683,38,1622,65,61,51
1400000US08059011701,8059011701,"Census Tract 117.01, Jefferson County, Colorado",2039,38,2021,46,18,30
1400000US08059011702,8059011702,"Census Tract 117.02, Jefferson County, Colorado",2282,48,2230,67,52,55
1400000US08059011708,8059011708,"Census Tract 117.08, Jefferson County, Colorado",1659,32,1578,73,81,74
1400000US08059011709,8059011709,"Census Tract 117.09, Jefferson County, Colorado",1582,31,1529,62,53,53
1400000US08059011710,8059011710,"Census Tract 117.10, Jefferson County, Colorado",1888,35,1679,123,209,117
1400000US08059011711,8059011711,"Census Tract 117.11, Jefferson County, Colorado",1874,35,1739,92,135,83
1400000US08059011712,8059011712,"Census Tract 117.12, Jefferson County, Colorado",1805,35,1771,53,34,39
1400000US08059011720,8059011720,"Census Tract 117.20, Jefferson County, Colorado",2063,64,1995,79,68,55
1400000US08059011721,8059011721,"Census Tract 117.21, Jefferson County, Colorado",1269,30,1202,74,67,70
1400000US08059011723,8059011723,"Census Tract 117.23, Jefferson County, Colorado",1681,40,1606,74,75,61
1400000US08059011724,8059011724,"Census Tract 117.24, Jefferson County, Colorado",1637,72,1583,74,54,58
1400000US08059011725,8059011725,"Census Tract 117.25, Jefferson County, Colorado",696,19,668,31,28,22
1400000US08059011726,8059011726,"Census Tract 117.26, Jefferson County, Colorado",2218,87,2182,101,36,53
1400000US08059011727,8059011727,"Census Tract 117.27, Jefferson County, Colorado",1526,30,1477,51,49,51
1400000US08059011728,8059011728,"Census Tract 117.28, Jefferson County, Colorado",1112,32,1112,32,0,12
1400000US08059011729,8059011729,"Census Tract 117.29, Jefferson County, Colorado",2005,43,1956,73,49,54
1400000US08059011730,8059011730,"Census Tract 117.30, Jefferson County, Colorado",1723,52,1660,75,63,61
1400000US08059011731,8059011731,"Census Tract 117.31, Jefferson County, Colorado",2056,63,1980,85,76,51
1400000US08059011732,8059011732,"Census Tract 117.32, Jefferson County, Colorado",2603,101,2565,114,38,60
1400000US08059011733,8059011733,"Census Tract 117.33, Jefferson County, Colorado",711,31,681,43,30,37
1400000US08059011803,8059011803,"Census Tract 118.03, Jefferson County, Colorado",2009,46,1966,58,43,43
1400000US08059011804,8059011804,"Census Tract 118.04, Jefferson County, Colorado",1612,36,1540,65,72,65
1400000US08059011805,8059011805,"Census Tract 118.05, Jefferson County, Colorado",2600,132,2523,154,77,63
1400000US08059011806,8059011806,"Census Tract 118.06, Jefferson County, Colorado",2254,58,2124,112,130,108
1400000US08059011904,8059011904,"Census Tract 119.04, Jefferson County, Colorado",1096,32,1064,57,32,43
1400000US08059011951,8059011951,"Census Tract 119.51, Jefferson County, Colorado",1396,46,1353,65,43,48
1400000US08059012022,8059012022,"Census Tract 120.22, Jefferson County, Colorado",2312,46,2312,46,0,17
1400000US08059012023,8059012023,"Census Tract 120.23, Jefferson County, Colorado",1330,45,1296,61,34,44
1400000US08059012024,8059012024,"Census Tract 120.24, Jefferson County, Colorado",1951,32,1925,50,26,42
1400000US08059012026,8059012026,"Census Tract 120.26, Jefferson County, Colorado",1672,74,1574,90,98,89
1400000US08059012027,8059012027,"Census Tract 120.27, Jefferson County, Colorado",1314,58,1206,81,108,74
1400000US08059012030,8059012030,"Census Tract 120.30, Jefferson County, Colorado",1695,32,1595,81,100,76
1400000US08059012031,8059012031,"Census Tract 120.31, Jefferson County, Colorado",1644,48,1451,96,193,85
1400000US08059012032,8059012032,"Census Tract 120.32, Jefferson County, Colorado",1079,24,992,69,87,62
1400000US08059012033,8059012033,"Census Tract 120.33, Jefferson County, Colorado",1263,48,1156,85,107,75
1400000US08059012034,8059012034,"Census Tract 120.34, Jefferson County, Colorado",1390,40,1344,63,46,49
1400000US08059012035,8059012035,"Census Tract 120.35, Jefferson County, Colorado",1870,37,1858,40,12,18
1400000US08059012036,8059012036,"Census Tract 120.36, Jefferson County, Colorado",1450,39,1369,67,81,67
1400000US08059012037,8059012037,"Census Tract 120.37, Jefferson County, Colorado",1544,64,1377,106,167,94
1400000US08059012038,8059012038,"Census Tract 120.38, Jefferson County, Colorado",1251,46,1251,46,0,12
1400000US08059012039,8059012039,"Census Tract 120.39, Jefferson County, Colorado",2041,46,2019,60,22,36
1400000US08059012041,8059012041,"Census Tract 120.41, Jefferson County, Colorado",2112,39,1919,144,193,129
1400000US08059012042,8059012042,"Census Tract 120.42, Jefferson County, Colorado",1417,33,1400,44,17,27
1400000US08059012043,8059012043,"Census Tract 120.43, Jefferson County, Colorado",2055,69,2037,70,18,22
1400000US08059012044,8059012044,"Census Tract 120.44, Jefferson County, Colorado",1578,36,1484,78,94,64
1400000US08059012045,8059012045,"Census Tract 120.45, Jefferson County, Colorado",2263,40,2233,58,30,46
1400000US08059012046,8059012046,"Census Tract 120.46, Jefferson County, Colorado",870,26,852,39,18,28
1400000US08059012047,8059012047,"Census Tract 120.47, Jefferson County, Colorado",1696,31,1581,79,115,67
1400000US08059012048,8059012048,"Census Tract 120.48, Jefferson County, Colorado",1102,30,1093,36,9,14
1400000US08059012049,8059012049,"Census Tract 120.49, Jefferson County, Colorado",1389,29,1277,70,112,66
1400000US08059012050,8059012050,"Census Tract 120.50, Jefferson County, Colorado",1798,39,1668,88,130,85
1400000US08059012051,8059012051,"Census Tract 120.51, Jefferson County, Colorado",1310,26,1298,30,12,20
1400000US08059012052,8059012052,"Census Tract 120.52, Jefferson County, Colorado",2141,36,2058,92,83,82
1400000US08059012053,8059012053,"Census Tract 120.53, Jefferson County, Colorado",1463,26,1463,26,0,12
1400000US08059012054,8059012054,"Census Tract 120.54, Jefferson County, Colorado",1614,64,1560,79,54,58
1400000US08059012055,8059012055,"Census Tract 120.55, Jefferson County, Colorado",1621,33,1593,52,28,42
1400000US08059012057,8059012057,"Census Tract 120.57, Jefferson County, Colorado",2682,70,2563,95,119,112
1400000US08059012058,8059012058,"Census Tract 120.58, Jefferson County, Colorado",2039,75,1557,103,482,110
1400000US08059012059,8059012059,"Census Tract 120.59, Jefferson County, Colorado",1199,27,1143,63,56,53
1400000US08059012060,8059012060,"Census Tract 120.60, Jefferson County, Colorado",1397,25,1313,71,84,73
1400000US08059015800,8059015800,"Census Tract 158, Jefferson County, Colorado",1855,33,1727,86,128,81
1400000US08059015900,8059015900,"Census Tract 159, Jefferson County, Colorado",1477,27,1360,69,117,63
1400000US08059060300,8059060300,"Census Tract 603, Jefferson County, Colorado",1608,50,1559,68,49,70
1400000US08059060400,8059060400,"Census Tract 604, Jefferson County, Colorado",1225,40,1225,40,0,12
1400000US08059060500,8059060500,"Census Tract 605, Jefferson County, Colorado",1872,80,1709,111,163,101
1400000US08059980000,8059980000,"Census Tract 9800, Jefferson County, Colorado",0,12,0,12,0,12
1400000US08059980400,8059980400,"Census Tract 9804, Jefferson County, Colorado",0,12,0,12,0,12
